10 10 20
07 03 06 20 11 15 10 14 06 04 
09 07 07 04 10 13 04 18 04 04 
05 17 04 09 11 19 03 03 12 16 
16 10 11 13 02 13 08 03 06 05 
06 06 11 05 01 12 17 04 02 12 
19 06 20 03 14 11 01 09 05 12 
16 12 13 06 05 14 18 04 09 15 
20 14 12 11 10 13 14 18 08 07 
09 07 04 09 01 10 11 01 18 15 
04 13 07 16 19 03 02 08 18 10 
