10 10 10
4 5 3 7 4 8 3 4 7 10 
5 6 3 4 9 6 5 1 9 5 
2 5 6 1 4 4 10 6 9 7 
1 3 3 5 9 6 5 4 1 1 
3 5 8 7 9 6 2 5 8 10 
9 9 6 6 2 1 1 1 9 10 
9 9 2 1 6 2 8 10 5 9 
2 9 5 9 5 5 6 6 9 3 
7 9 1 5 6 4 5 7 5 3 
8 3 4 9 6 1 2 3 10 9 
