10 10 10
9 3 7 3 8 1 5 3 8 8 
5 8 1 9 8 5 9 2 10 7 
7 9 3 3 3 3 4 9 9 8 
8 9 3 6 1 10 6 8 4 5 
5 1 3 7 9 10 4 7 3 5 
4 9 4 8 3 6 10 8 7 10 
8 4 8 10 9 1 1 6 8 4 
1 4 4 5 3 2 6 6 9 8 
10 4 8 3 3 10 1 5 9 7 
4 6 10 4 5 10 6 5 5 3 
