10 10 15
12 03 06 15 06 15 15 09 11 04 
14 12 12 09 10 08 09 03 04 09 
15 12 14 04 06 14 13 03 02 11 
01 05 06 13 12 03 13 03 11 15 
06 01 11 10 01 12 02 09 07 12 
09 06 15 08 09 06 06 14 15 07 
01 07 03 06 05 14 08 09 09 10 
15 14 02 11 15 03 14 08 03 12 
04 12 09 04 11 10 01 01 08 15 
14 08 07 01 14 03 07 13 03 15 
