10 10 10
3 4 6 9 9 7 7 2 7 2 
8 2 6 5 7 6 10 6 8 6 
4 2 8 5 1 4 3 7 10 2 
10 4 7 5 4 7 4 10 8 10 
3 8 1 9 2 9 4 3 5 1 
10 10 4 7 4 6 3 6 2 4 
9 1 7 6 8 10 2 1 1 2 
2 3 9 3 1 10 3 6 4 9 
8 4 8 1 2 1 9 4 8 10 
7 7 3 5 2 2 6 5 2 6 
