10 10 15
14 15 14 12 15 10 08 01 03 02 
01 08 15 13 13 02 06 06 03 14 
08 04 06 13 11 08 01 14 11 02 
08 09 01 06 12 01 01 04 08 10 
13 08 02 12 12 07 14 02 04 08 
07 11 03 04 08 14 12 15 04 07 
01 11 08 08 02 04 08 09 15 07 
03 12 14 11 15 10 09 05 03 12 
12 09 07 07 13 14 12 09 05 07 
07 05 02 14 13 10 03 12 10 02 
