10 10 12
01 05 07 04 09 02 10 01 04 10 
10 02 04 04 08 04 01 07 10 06 
11 02 04 02 03 06 03 12 12 03 
11 05 07 05 12 07 10 01 07 01 
11 09 02 02 12 02 09 12 12 11 
09 03 04 05 04 06 10 10 05 01 
12 07 09 10 11 09 05 01 09 03 
01 07 11 07 12 02 12 01 05 03 
11 06 05 02 10 01 11 07 10 03 
11 10 01 08 07 11 04 03 03 04 
