10 10 20
19 15 14 12 10 20 03 01 13 17 
16 13 10 13 08 02 01 01 13 14 
03 09 11 18 06 08 11 14 06 02 
08 04 16 01 07 06 01 09 18 05 
18 13 17 07 17 17 09 17 09 13 
02 11 13 04 08 19 12 10 04 17 
11 11 13 18 12 19 03 04 20 12 
08 17 04 16 15 20 04 15 08 12 
07 09 02 12 13 09 02 04 10 17 
12 20 07 04 18 10 03 12 05 02 
