10 10 10
5 9 5 2 9 4 6 1 8 6 
6 2 4 10 8 4 5 7 6 6 
5 10 4 10 7 6 9 10 10 7 
5 7 5 9 10 5 4 7 5 1 
3 3 2 6 2 2 1 6 10 9 
3 7 10 9 6 6 4 6 5 5 
2 1 3 8 9 3 3 5 9 9 
5 1 1 9 8 4 2 1 1 3 
9 6 9 8 4 7 5 7 2 9 
3 4 1 6 1 9 8 5 5 8 
