10 10 12
11 03 02 12 06 04 11 01 09 05 
04 05 06 01 04 02 09 09 09 02 
11 01 03 10 02 08 07 02 02 02 
08 12 04 09 03 10 01 01 02 01 
10 05 05 03 09 01 05 05 01 05 
10 11 09 04 08 11 12 06 04 01 
07 11 05 02 08 07 11 12 12 04 
12 09 08 08 03 04 12 11 12 12 
03 09 10 04 01 05 06 12 02 01 
04 08 11 08 10 10 03 12 01 02 
