10 10 15
09 13 02 08 03 06 10 03 13 03 
10 08 11 14 03 15 09 07 05 02 
12 09 13 03 08 08 14 14 09 03 
03 09 08 11 01 10 01 03 04 05 
05 06 13 07 04 15 14 12 13 10 
14 09 04 03 03 11 10 08 02 10 
03 04 03 10 14 11 11 06 13 14 
11 09 04 15 08 07 06 06 04 03 
15 09 03 03 03 05 06 05 04 07 
14 06 10 09 15 15 11 10 05 08 
