10 10 5
4 5 4 2 5 5 3 1 3 2 
1 3 5 3 3 2 1 1 3 4 
3 4 1 3 1 3 1 4 1 2 
3 4 1 1 2 1 1 4 3 5 
3 3 2 2 2 2 4 2 4 3 
2 1 3 4 3 4 2 5 4 2 
1 1 3 3 2 4 3 4 5 2 
3 2 4 1 5 5 4 5 3 2 
2 4 2 2 3 4 2 4 5 2 
2 5 2 4 3 5 3 2 5 2 
