10 10 15
10 14 10 07 09 14 01 01 13 01 
01 02 04 10 08 04 10 07 01 06 
05 05 04 05 12 06 09 15 15 12 
05 02 10 14 15 10 04 07 10 01 
08 03 02 11 12 02 06 06 15 14 
03 12 10 14 01 06 04 01 05 10 
12 01 03 13 14 03 08 10 09 09 
10 01 11 04 03 14 12 01 11 03 
14 06 14 08 04 07 05 07 07 09 
08 04 01 11 01 14 13 15 15 13 
