10 10 7
4 7 1 5 7 1 2 5 7 5 
1 1 2 3 2 6 1 6 3 7 
4 5 7 4 3 1 2 2 1 3 
7 4 2 6 7 6 6 1 1 5 
6 2 4 5 2 5 4 2 1 4 
1 5 2 5 6 2 6 7 3 6 
7 1 2 7 6 1 5 2 7 6 
6 3 5 7 7 4 5 1 5 5 
5 4 7 4 1 6 5 6 3 6 
4 3 6 4 7 2 2 2 3 1 
