10 10 15
14 15 08 02 04 03 13 09 07 05 
10 11 03 04 09 11 05 11 09 10 
07 05 11 06 04 14 05 06 14 07 
01 13 13 15 14 01 10 04 01 01 
08 10 03 02 14 11 12 10 13 05 
04 04 01 06 02 11 11 06 09 10 
04 09 07 01 01 12 08 10 15 09 
02 14 10 04 15 15 06 11 09 03 
07 04 06 15 01 14 10 12 05 03 
13 08 04 04 01 11 07 08 05 14 
