10 10 12
02 09 05 11 10 06 01 06 01 08 
01 02 09 04 09 08 05 05 03 01 
04 11 08 03 10 02 02 12 05 01 
01 07 01 09 05 10 07 10 07 07 
05 07 12 05 11 08 12 07 04 02 
07 07 04 06 02 05 11 03 09 04 
07 09 10 07 10 06 08 04 03 03 
02 11 01 01 03 03 12 02 09 03 
07 07 09 03 04 02 07 03 05 03 
10 11 04 07 10 05 04 05 08 11 
