10 10 7
4 3 4 7 3 3 7 1 5 6 
1 6 6 5 1 5 5 4 6 6 
1 3 7 7 2 2 7 6 4 4 
7 6 6 3 3 6 3 7 6 7 
6 5 5 4 2 4 6 6 5 3 
2 4 3 7 3 4 1 7 2 2 
3 6 5 6 1 1 5 2 7 1 
1 5 5 4 6 4 5 3 7 7 
5 7 3 7 6 4 1 6 3 2 
5 6 5 3 4 5 3 6 4 7 
