10 10 7
3 7 1 4 2 6 5 5 4 1 
1 4 7 5 4 2 5 4 7 4 
6 1 3 5 6 5 3 2 4 6 
6 4 4 4 7 5 2 3 7 3 
3 6 7 7 3 3 7 7 4 4 
4 2 5 4 4 3 1 4 3 2 
1 1 5 4 4 3 6 3 5 5 
6 5 3 3 3 5 3 2 5 6 
5 6 5 2 7 1 3 6 2 5 
7 2 5 3 5 6 3 3 1 7 
