10 10 10
10 1 5 7 10 7 9 5 9 8 
1 1 9 4 5 7 4 6 3 5 
9 10 7 4 9 9 5 8 8 1 
7 7 1 4 6 2 10 4 8 8 
2 9 1 2 4 5 9 7 2 3 
1 1 3 9 6 3 8 10 10 5 
2 9 1 5 2 6 6 3 2 4 
10 5 4 2 6 9 7 6 5 8 
9 8 10 3 6 6 5 3 7 7 
7 9 5 10 5 8 7 2 10 8 
