10 10 7
3 7 3 5 1 2 2 4 3 2 
6 4 1 3 7 7 7 6 2 4 
1 1 7 6 7 5 5 6 7 5 
1 7 3 1 3 1 3 2 4 3 
3 7 6 2 7 3 1 6 7 7 
7 7 5 7 5 5 4 1 1 3 
3 6 7 5 7 2 5 7 2 6 
7 4 3 6 3 3 6 1 6 3 
7 6 7 5 3 3 7 6 3 7 
6 5 6 5 3 3 5 5 7 6 
