10 10 20
05 09 15 12 09 14 06 01 08 06 
06 02 04 20 08 04 05 07 06 06 
15 10 04 10 07 06 19 20 20 07 
15 17 15 09 20 15 14 17 15 01 
03 13 02 06 12 02 01 16 20 19 
13 07 20 09 16 06 14 06 05 05 
12 11 13 18 19 13 13 05 09 19 
05 11 11 19 08 14 12 01 01 03 
19 06 09 18 14 17 15 07 02 19 
03 14 01 16 11 19 08 15 15 08 
