10 10 7
7 7 2 5 4 4 2 6 3 4 
3 2 3 3 7 3 2 5 6 3 
7 3 1 3 1 7 4 3 2 6 
5 2 3 4 6 6 6 6 2 1 
2 4 7 2 7 6 4 6 1 2 
1 7 2 6 1 7 3 4 1 5 
7 5 6 2 7 2 5 5 7 7 
3 6 1 2 7 5 5 3 3 5 
2 1 4 2 4 2 1 7 6 1 
2 5 4 7 5 1 6 2 5 4 
