10 10 10
7 3 6 10 1 5 10 4 6 4 
9 7 7 4 10 3 4 8 4 4 
5 7 4 9 1 9 3 3 2 6 
6 10 1 3 2 3 8 3 6 5 
6 6 1 5 1 2 7 4 2 2 
9 6 10 3 4 1 1 9 5 2 
6 2 3 6 5 4 8 4 9 5 
10 4 2 1 10 3 4 8 8 7 
9 7 4 9 1 10 1 1 8 5 
4 3 7 6 9 3 2 8 8 10 
