10 10 12
03 03 06 12 03 03 06 06 02 04 
05 03 03 12 10 05 12 06 04 12 
09 09 08 01 03 11 07 03 08 08 
04 02 03 01 06 09 04 03 02 09 
06 10 11 01 01 12 05 12 10 12 
03 06 12 11 06 03 09 05 09 04 
04 04 09 06 05 02 02 12 09 07 
12 02 08 11 06 09 02 02 12 03 
01 03 12 01 05 10 07 01 02 03 
08 05 07 04 11 03 10 04 06 06 
