10 10 20
03 14 06 09 19 17 17 02 07 12 
08 02 16 05 07 06 10 16 18 16 
14 02 08 15 01 14 03 07 20 12 
10 14 17 15 14 07 04 10 08 10 
13 08 11 09 12 09 14 13 05 11 
20 10 04 07 04 16 13 06 02 04 
09 11 17 06 18 10 12 01 11 12 
02 03 19 13 11 10 13 16 14 09 
18 14 18 01 12 01 09 04 18 10 
07 07 13 15 12 02 16 15 02 06 
