10 10 20
09 03 07 13 08 01 05 03 18 08 
05 08 11 19 18 05 09 12 10 17 
17 09 03 03 13 03 04 19 09 18 
18 09 13 16 01 20 16 18 14 05 
05 11 13 07 09 10 04 17 13 05 
14 09 14 08 03 06 10 18 17 10 
08 14 18 20 09 11 11 16 08 04 
01 04 14 05 03 02 06 06 19 18 
10 04 18 03 03 20 01 05 09 17 
14 16 10 04 15 10 06 05 05 13 
