10 10 20
14 05 13 07 14 18 13 14 17 20 
05 06 13 04 09 16 05 01 19 05 
12 15 16 11 14 14 10 16 09 17 
01 03 13 05 09 06 15 14 11 11 
13 15 08 17 19 16 12 15 08 10 
19 19 16 06 02 01 11 11 09 20 
19 09 02 11 06 02 08 20 15 19 
02 19 05 09 15 15 16 06 09 03 
07 19 01 15 16 14 15 07 05 03 
18 03 04 19 06 01 12 13 20 19 
