10 10 7
2 7 4 7 7 7 7 5 7 2 
2 7 1 2 1 5 4 2 5 4 
7 4 3 7 1 3 5 6 7 1 
6 6 5 2 3 2 7 2 6 6 
1 6 5 2 7 3 6 1 5 3 
2 2 4 4 1 2 5 5 7 2 
3 5 7 1 5 2 2 4 1 6 
7 1 4 5 2 3 5 5 1 7 
5 3 1 1 4 1 1 1 3 7 
2 6 3 6 6 5 5 5 1 5 
