10 10 15
08 14 11 14 04 07 12 07 12 07 
13 02 06 15 12 01 15 06 03 11 
04 12 13 15 06 14 08 07 10 12 
10 09 02 05 14 12 04 10 03 15 
08 08 01 14 07 04 14 13 10 01 
15 05 04 12 04 01 03 11 07 04 
14 01 12 01 13 10 12 01 11 07 
07 03 14 08 01 05 03 06 09 04 
13 09 08 01 12 11 09 14 13 15 
02 12 08 05 12 12 06 15 12 01 
