10 10 10
9 5 4 2 10 10 3 1 3 7 
6 3 10 3 8 2 1 1 3 4 
3 9 1 8 6 8 1 4 6 2 
8 4 6 1 7 6 1 9 8 5 
8 3 7 7 7 7 9 7 9 3 
2 1 3 4 8 9 2 10 4 7 
1 1 3 8 2 9 3 4 10 2 
8 7 4 6 5 10 4 5 8 2 
7 9 2 2 3 9 2 4 10 7 
2 10 7 4 8 10 3 2 5 2 
