10 10 12
09 07 11 05 12 09 01 03 10 12 
01 08 11 11 06 09 09 04 02 05 
09 09 07 03 05 11 08 11 09 06 
06 09 05 08 01 04 04 06 10 05 
05 03 01 07 01 06 08 09 01 01 
02 09 10 12 03 02 10 02 05 10 
12 10 06 04 05 11 11 12 04 08 
05 12 10 09 11 10 06 06 07 06 
06 12 06 03 03 08 09 05 01 01 
02 12 10 12 03 06 02 01 05 05 
