10 10 12
02 01 03 11 06 01 07 03 07 10 
11 09 01 06 03 11 02 06 05 01 
11 06 09 04 01 05 07 02 10 01 
05 11 01 12 02 10 12 08 04 06 
06 03 07 10 12 09 09 01 06 05 
01 05 11 01 12 03 06 06 04 03 
10 01 01 03 12 02 12 03 02 04 
08 11 10 06 08 01 03 08 01 08 
01 06 04 03 06 04 05 11 01 01 
01 11 01 06 05 04 11 08 06 12 
