10 10 12
11 02 02 05 07 01 09 10 03 04 
04 02 12 09 03 10 06 12 06 08 
10 06 04 03 09 02 11 07 04 12 
10 06 05 11 02 03 04 10 12 06 
05 08 07 05 04 01 02 01 01 07 
12 02 04 03 04 04 09 02 10 04 
05 07 09 10 10 10 12 01 11 04 
10 03 11 05 07 02 09 12 06 01 
10 06 02 01 12 05 09 08 10 06 
11 03 05 11 12 06 12 03 06 10 
