10 10 15
05 01 15 02 15 07 04 15 04 13 
11 06 04 09 15 02 14 06 08 10 
14 15 12 04 04 14 10 08 13 01 
02 02 01 09 11 07 15 14 13 03 
12 09 01 07 09 15 09 07 12 08 
01 11 08 04 06 03 03 15 10 15 
07 04 01 15 12 11 06 03 02 04 
05 05 04 12 11 04 12 11 10 08 
04 03 10 03 06 01 05 08 07 07 
07 14 10 15 05 13 02 02 15 03 
