10 10 7
1 1 4 5 7 5 7 7 2 7 
1 6 4 5 4 6 2 4 3 1 
6 6 1 5 3 4 1 5 5 1 
2 5 1 5 7 1 3 6 5 2 
4 5 7 7 7 2 6 1 3 6 
6 1 2 4 5 5 1 3 7 5 
3 1 1 1 6 7 1 6 4 3 
7 7 7 4 4 6 3 7 4 5 
5 2 5 5 6 2 7 6 2 4 
1 4 4 1 5 7 1 3 3 4 
