10 10 20
10 01 15 07 10 17 19 15 19 18 
11 01 09 14 15 07 14 06 13 05 
19 10 17 04 09 09 15 18 18 01 
17 07 01 04 06 02 20 04 08 18 
02 19 11 02 04 05 09 17 02 13 
01 01 03 09 16 03 18 10 20 15 
02 09 01 15 12 06 16 03 02 04 
20 15 14 02 16 09 07 16 05 08 
09 18 20 03 06 16 05 03 17 17 
17 19 05 10 05 08 07 12 10 08 
