20 20 15
08 14 11 14 04 07 12 07 12 07 13 02 06 15 12 01 15 06 03 11 
04 12 13 15 06 14 08 07 10 12 10 09 02 05 14 12 04 10 03 15 
08 08 01 14 07 04 14 13 10 01 15 05 04 12 04 01 03 11 07 04 
14 01 12 01 13 10 12 01 11 07 07 03 14 08 01 05 03 06 09 04 
13 09 08 01 12 11 09 14 13 15 02 12 08 05 12 12 06 15 12 01 
06 10 11 11 02 11 15 05 09 01 15 06 09 08 07 12 03 15 11 08 
06 04 04 13 09 07 09 14 13 12 07 04 07 02 14 15 04 06 11 12 
13 11 03 13 03 01 09 12 07 11 11 12 15 14 02 15 12 02 13 10 
06 11 05 04 12 10 03 08 07 06 04 04 08 13 01 02 05 02 13 03 
12 09 15 11 14 08 10 03 01 15 12 06 10 08 09 14 09 12 13 01 
09 08 11 01 06 04 02 02 05 06 05 01 06 11 12 12 03 13 14 03 
12 02 01 14 09 09 04 02 12 01 09 05 08 05 12 05 15 13 07 04 
04 03 04 01 13 07 12 07 05 10 09 08 11 01 13 11 10 08 05 06 
15 13 03 15 09 14 04 15 04 02 03 07 04 07 14 01 05 11 14 09 
12 08 09 15 15 13 10 09 06 14 07 05 04 09 04 04 14 15 04 02 
01 13 15 12 11 14 04 01 01 03 01 12 02 09 11 01 07 13 10 04 
11 08 08 06 01 04 02 14 03 12 08 10 09 07 06 05 05 02 05 05 
04 12 09 05 06 04 12 04 01 06 07 04 05 14 01 05 09 09 11 11 
05 03 13 06 09 03 02 06 04 13 02 14 09 10 10 14 06 07 09 06 
04 15 01 09 06 09 05 14 02 15 02 14 09 14 04 10 08 05 15 04 
