20 20 15
12 03 06 15 06 15 15 09 11 04 14 12 12 09 10 08 09 03 04 09 
15 12 14 04 06 14 13 03 02 11 01 05 06 13 12 03 13 03 11 15 
06 01 11 10 01 12 02 09 07 12 09 06 15 08 09 06 06 14 15 07 
01 07 03 06 05 14 08 09 09 10 15 14 02 11 15 03 14 08 03 12 
04 12 09 04 11 10 01 01 08 15 14 08 07 01 14 03 07 13 03 15 
15 02 05 08 04 05 10 03 04 05 14 08 08 15 03 03 09 10 03 01 
01 08 08 07 15 13 01 06 03 03 12 02 12 09 01 15 05 11 09 08 
07 15 07 06 14 01 08 07 10 02 07 11 09 06 09 08 04 02 06 06 
11 09 14 07 09 14 14 13 01 07 13 14 06 04 04 04 12 03 10 13 
04 01 15 04 07 09 04 02 02 01 14 12 09 04 11 03 02 09 07 10 
15 04 15 13 15 04 01 11 06 11 15 02 03 15 05 01 08 15 09 01 
15 07 04 01 10 14 03 04 14 01 05 06 12 04 03 11 07 03 13 05 
05 12 06 15 11 02 07 10 02 01 02 08 07 06 08 09 04 02 12 10 
03 01 15 14 04 02 01 03 11 13 07 01 01 04 07 04 05 13 05 13 
13 07 06 05 04 13 13 07 07 01 01 09 01 07 14 11 08 14 13 04 
03 11 11 10 06 02 13 03 14 10 15 12 08 12 08 11 02 12 09 08 
12 10 01 04 08 06 06 01 04 04 11 06 06 06 07 12 07 05 14 12 
06 05 08 13 09 07 08 10 03 01 09 06 02 01 09 10 06 15 10 09 
10 05 06 07 02 12 10 08 08 15 11 13 05 04 02 05 02 09 14 05 
10 14 10 11 14 11 12 04 10 13 04 11 02 01 02 10 04 04 09 04 
