20 20 20
03 14 06 09 19 17 17 02 07 12 08 02 16 05 07 06 10 16 18 16 
14 02 08 15 01 14 03 07 20 12 10 14 17 15 14 07 04 10 08 10 
13 08 11 09 12 09 14 13 05 11 20 10 04 07 04 16 13 06 02 04 
09 11 17 06 18 10 12 01 11 12 02 03 19 13 11 10 13 16 14 09 
18 14 18 01 12 01 09 04 18 10 07 07 13 15 12 02 16 15 02 06 
06 15 01 16 07 11 05 20 19 11 20 16 04 18 17 07 18 05 11 08 
06 09 14 18 04 17 19 19 03 12 17 09 07 17 04 05 19 01 16 17 
03 16 13 18 13 01 04 02 17 06 01 02 15 14 12 10 02 02 08 05 
06 16 05 04 12 20 08 03 12 16 19 14 03 03 11 07 15 07 08 03 
12 09 05 06 14 08 15 08 01 15 12 06 10 08 09 14 19 17 08 11 
04 18 16 06 01 19 12 07 05 11 10 16 11 06 02 17 13 08 04 13 
02 07 11 04 14 19 09 12 07 16 14 10 13 10 07 05 20 18 12 04 
09 13 19 11 18 12 07 02 20 10 14 13 16 16 08 01 15 08 05 01 
15 18 03 20 19 09 04 10 19 07 13 07 19 12 09 16 15 16 09 14 
17 03 19 05 10 18 05 04 06 09 17 20 19 19 19 09 19 15 19 17 
01 03 15 12 06 04 19 01 11 08 06 07 02 04 11 11 02 08 15 19 
16 03 18 06 01 09 07 19 03 17 08 15 19 02 06 05 05 17 05 15 
04 02 14 05 06 04 07 19 11 01 17 19 15 14 16 15 14 14 06 16 
10 13 03 01 14 08 17 11 04 13 17 19 14 10 15 19 06 02 09 16 
14 05 06 09 11 14 15 04 07 20 12 09 04 14 09 10 13 05 20 09 
