20 20 15
14 15 14 12 15 10 08 01 03 02 01 08 15 13 13 02 06 06 03 14 
08 04 06 13 11 08 01 14 11 02 08 09 01 06 12 01 01 04 08 10 
13 08 02 12 12 07 14 02 04 08 07 11 03 04 08 14 12 15 04 07 
01 11 08 08 02 04 08 09 15 07 03 12 14 11 15 10 09 05 03 12 
12 09 07 07 13 14 12 09 05 07 07 05 02 14 13 10 03 12 10 02 
04 04 05 02 15 04 04 15 01 06 12 12 15 10 10 04 01 06 04 05 
12 10 10 06 09 14 07 03 10 02 11 05 05 15 14 11 10 02 11 10 
14 14 14 05 08 08 08 08 06 11 13 09 06 14 14 06 12 06 15 06 
14 10 03 03 01 01 06 02 09 01 12 07 14 02 12 13 09 11 06 06 
07 03 15 04 01 13 01 12 10 07 09 08 01 03 03 08 03 08 09 11 
15 12 10 05 13 06 02 14 01 07 04 14 01 10 09 01 08 01 04 09 
07 05 09 14 07 11 06 02 10 15 12 09 11 06 13 01 03 06 14 11 
05 02 01 05 12 10 13 11 02 08 11 09 12 04 07 11 14 05 12 15 
04 15 08 06 06 12 06 15 10 11 10 14 13 11 03 01 12 15 03 13 
08 13 13 11 09 05 06 14 09 09 14 04 09 13 01 14 10 14 05 04 
09 15 02 13 02 11 05 13 03 07 02 02 12 15 12 05 11 10 10 11 
03 08 14 11 06 06 01 07 04 13 10 05 12 03 02 05 05 07 09 07 
05 10 15 01 09 12 12 11 13 07 06 07 06 11 10 03 02 02 09 12 
14 10 01 02 04 10 06 09 01 14 07 05 09 07 13 09 10 01 12 07 
14 02 05 12 13 14 14 06 01 08 02 06 09 10 08 13 04 13 06 11 
