20 20 15
10 14 10 07 09 14 01 01 13 01 01 02 04 10 08 04 10 07 01 06 
05 05 04 05 12 06 09 15 15 12 05 02 10 14 15 10 04 07 10 01 
08 03 02 11 12 02 06 06 15 14 03 12 10 14 01 06 04 01 05 10 
12 01 03 13 14 03 08 10 09 09 10 01 11 04 03 14 12 01 11 03 
14 06 14 08 04 07 05 07 07 09 08 04 01 11 01 14 13 15 15 13 
01 02 14 03 05 08 02 08 08 04 10 06 09 01 05 04 07 09 10 13 
09 03 08 09 05 01 15 02 15 14 14 07 15 04 10 11 12 03 10 11 
06 12 09 07 12 13 10 03 14 05 07 14 14 15 08 03 15 14 11 06 
04 01 13 11 12 07 06 15 09 08 10 06 04 03 12 15 08 07 09 06 
03 15 11 08 14 03 02 05 08 12 11 12 04 15 07 15 06 04 06 06 
11 01 11 06 10 08 05 02 14 05 14 01 05 10 15 10 04 01 15 04 
04 02 07 07 01 05 14 06 08 04 03 11 11 13 01 06 05 13 14 10 
09 05 02 13 06 01 08 01 01 14 11 11 07 02 03 07 06 08 04 06 
03 06 08 14 10 15 11 15 12 01 01 06 12 03 10 09 10 09 10 03 
14 05 13 05 14 07 11 04 14 06 01 09 03 08 14 13 08 09 04 11 
01 04 08 13 13 03 13 15 03 07 02 02 04 06 06 02 13 09 12 03 
14 13 11 02 05 09 14 12 09 02 08 10 12 15 14 10 09 11 09 12 
10 02 13 13 07 10 06 04 03 02 14 02 14 09 10 11 10 08 07 03 
01 06 04 12 13 09 13 13 12 13 09 06 14 13 10 13 08 07 01 02 
08 06 03 14 15 04 01 09 03 07 03 03 05 14 07 09 07 11 06 03 
