20 20 15
09 13 02 08 03 06 10 03 13 03 10 08 11 14 03 15 09 07 05 02 
12 09 13 03 08 08 14 14 09 03 03 09 08 11 01 10 01 03 04 05 
05 06 13 07 04 15 14 12 13 10 14 09 04 03 03 11 10 08 02 10 
03 04 03 10 14 11 11 06 13 14 11 09 04 15 08 07 06 06 04 03 
15 09 03 03 03 05 06 05 04 07 14 06 10 09 15 15 11 10 05 08 
01 07 08 04 06 15 03 11 12 06 13 04 06 15 13 08 11 03 12 15 
09 03 05 10 03 12 09 13 13 06 12 13 12 04 02 03 11 04 05 07 
01 03 10 06 09 08 05 12 02 02 03 03 04 14 12 06 10 13 10 08 
10 06 12 06 09 13 15 04 08 05 11 15 14 12 12 14 11 02 10 13 
03 12 15 13 11 03 10 12 07 04 11 01 09 08 14 02 05 13 13 05 
09 15 11 07 11 08 06 14 09 07 11 03 11 02 15 13 11 01 09 03 
04 05 10 04 12 08 12 08 06 09 04 14 08 15 13 11 07 10 09 07 
01 11 09 11 04 15 08 14 15 09 08 10 13 03 13 01 10 09 15 07 
03 04 13 02 10 10 12 08 04 12 14 11 07 07 14 02 13 13 08 12 
06 15 13 10 09 10 10 11 03 02 02 12 12 14 06 06 15 02 13 10 
06 03 06 04 09 04 06 13 01 13 01 14 04 13 08 05 07 10 15 01 
11 08 05 14 14 10 04 13 03 08 08 08 10 05 12 10 08 09 14 15 
13 14 05 01 11 13 12 02 07 03 09 09 11 13 14 09 14 09 13 02 
01 05 09 02 01 12 03 08 05 01 15 02 14 04 10 09 08 06 02 06 
09 10 06 11 15 04 11 13 12 08 14 04 05 15 05 05 11 14 05 01 
