20 20 20
14 05 13 07 14 18 13 14 17 20 05 06 13 04 09 16 05 01 19 05 
12 15 16 11 14 14 10 16 09 17 01 03 13 05 09 06 15 14 11 11 
13 15 08 17 19 16 12 15 08 10 19 19 16 06 02 01 11 11 09 20 
19 09 02 11 06 02 08 20 15 19 02 19 05 09 15 15 16 06 09 03 
07 19 01 15 16 14 15 07 05 03 18 03 04 19 06 01 12 13 20 19 
11 01 17 08 09 04 02 16 01 11 18 08 09 10 02 05 04 08 03 20 
03 20 14 18 10 19 18 01 12 17 11 14 09 08 01 09 03 15 04 03 
05 13 02 05 02 15 01 05 03 03 16 17 14 10 14 03 08 03 16 11 
11 06 17 19 05 09 19 07 03 02 10 19 14 11 04 07 06 16 04 20 
19 19 16 04 08 01 07 08 03 14 10 05 19 06 15 16 15 13 02 09 
14 03 08 19 14 03 05 11 18 20 02 08 19 17 12 06 09 10 05 03 
03 15 07 13 20 01 08 06 13 10 07 18 04 06 08 17 08 04 19 17 
04 20 05 02 08 08 19 16 17 16 18 11 10 16 15 01 16 03 19 20 
04 17 09 07 02 16 16 01 12 06 17 15 06 13 08 05 20 18 01 08 
13 10 10 14 18 05 07 05 19 05 05 02 01 05 20 14 01 15 14 04 
01 10 18 18 15 17 02 06 06 14 06 19 16 15 04 13 11 10 17 09 
06 13 02 18 18 02 11 10 16 04 13 08 06 02 17 20 10 11 05 15 
04 02 05 11 17 09 15 19 10 12 08 16 16 01 13 05 02 04 14 10 
19 18 09 04 11 06 15 20 16 12 15 11 13 19 02 01 19 08 20 09 
19 19 16 07 19 20 11 01 15 17 02 14 14 10 09 17 07 04 16 02 
