20 20 12
11 02 02 05 07 01 09 10 03 04 04 02 12 09 03 10 06 12 06 08 
10 06 04 03 09 02 11 07 04 12 10 06 05 11 02 03 04 10 12 06 
05 08 07 05 04 01 02 01 01 07 12 02 04 03 04 04 09 02 10 04 
05 07 09 10 10 10 12 01 11 04 10 03 11 05 07 02 09 12 06 01 
10 06 02 01 12 05 09 08 10 06 11 03 05 11 12 06 12 03 06 10 
06 07 05 08 11 11 09 08 03 07 12 12 12 02 01 03 06 09 11 08 
06 01 10 10 12 01 03 11 07 12 01 01 07 05 08 09 07 09 08 09 
07 08 09 10 09 01 12 06 01 02 05 06 03 02 08 06 06 02 04 01 
06 08 05 04 12 04 12 11 04 12 07 10 11 07 07 11 11 11 04 03 
12 09 09 02 02 08 07 12 01 03 12 06 10 08 09 02 03 09 04 07 
12 02 08 10 09 07 08 11 05 03 02 04 03 02 06 09 09 04 08 09 
06 11 07 08 06 03 01 08 03 04 06 02 05 02 03 05 12 10 04 04 
01 09 07 07 10 04 03 10 08 10 06 05 08 04 04 05 07 08 05 09 
03 10 03 12 03 05 04 06 07 11 09 07 07 04 05 04 11 08 05 06 
09 11 03 09 06 10 01 12 06 05 01 08 07 03 07 01 11 03 07 05 
01 07 03 12 02 08 07 01 07 12 10 03 02 12 11 07 10 04 07 07 
08 11 02 06 01 01 11 11 03 09 08 07 03 10 06 05 05 05 05 11 
04 06 06 05 06 04 03 07 07 09 01 07 11 02 04 11 06 06 02 08 
02 09 07 09 06 12 05 03 04 01 05 11 06 10 07 11 06 10 09 12 
10 09 10 09 03 06 11 08 11 12 08 05 12 02 01 10 05 05 12 01 
