20 20 10
10 1 5 7 10 7 9 5 9 8 1 1 9 4 5 7 4 6 3 5 
9 10 7 4 9 9 5 8 8 1 7 7 1 4 6 2 10 4 8 8 
2 9 1 2 4 5 9 7 2 3 1 1 3 9 6 3 8 10 10 5 
2 9 1 5 2 6 6 3 2 4 10 5 4 2 6 9 7 6 5 8 
9 8 10 3 6 6 5 3 7 7 7 9 5 10 5 8 7 2 10 8 
7 1 4 10 3 10 10 1 7 5 8 7 2 10 9 7 7 4 10 5 
2 8 5 6 7 9 5 4 1 4 3 7 6 9 9 10 8 8 10 6 
4 10 3 5 9 3 4 7 6 3 3 7 2 8 4 9 8 10 4 8 
5 8 7 1 6 7 10 5 6 10 3 10 9 5 4 9 7 7 7 5 
1 9 3 3 6 9 3 4 8 8 3 3 7 1 5 3 7 6 9 3 
5 1 2 5 7 7 5 6 4 1 10 6 2 4 10 7 2 2 2 2 
9 7 6 6 7 10 10 6 7 10 10 2 1 1 8 9 9 3 4 2 
5 5 10 6 9 9 5 2 1 6 5 1 4 10 8 3 1 9 8 8 
9 7 1 1 9 8 9 7 2 3 1 7 7 10 2 7 10 6 9 2 
4 5 3 7 5 2 1 7 3 10 4 1 6 6 3 6 6 1 5 7 
5 5 3 4 6 5 2 5 2 2 9 5 7 1 4 1 4 4 9 6 
4 3 8 1 10 10 9 5 3 3 2 9 9 4 4 6 10 6 2 4 
7 10 8 3 2 3 5 6 9 4 3 2 8 1 4 7 2 4 2 4 
6 5 5 6 10 8 1 10 3 3 5 2 4 2 4 6 7 9 3 5 
4 5 6 1 7 1 7 9 5 10 4 2 4 8 8 4 6 10 5 10 
