20 20 20
19 15 14 12 10 20 03 01 13 17 16 13 10 13 08 02 01 01 13 14 
03 09 11 18 06 08 11 14 06 02 08 04 16 01 07 06 01 09 18 05 
18 13 17 07 17 17 09 17 09 13 02 11 13 04 08 19 12 10 04 17 
11 11 13 18 12 19 03 04 20 12 08 17 04 16 15 20 04 15 08 12 
07 09 02 12 13 09 02 04 10 17 12 20 07 04 18 10 03 12 05 02 
04 04 10 07 20 04 19 15 11 06 07 17 15 20 20 19 01 01 14 10 
17 05 10 16 09 19 17 03 10 02 16 05 05 05 04 16 20 02 11 10 
19 09 19 05 08 18 03 08 11 16 18 19 01 19 14 01 17 11 15 06 
04 10 03 08 06 06 16 17 19 06 07 17 14 17 02 13 14 16 01 16 
12 18 15 04 16 08 16 12 10 02 09 13 11 03 13 08 08 08 04 06 
05 02 15 10 18 16 02 04 11 02 19 14 11 05 09 06 13 16 09 14 
17 10 19 19 12 11 06 12 10 10 17 14 11 11 03 01 18 16 04 01 
10 02 06 20 07 15 18 11 02 18 16 19 07 14 17 11 04 15 02 05 
04 10 18 06 01 12 06 10 20 01 10 09 03 16 08 01 02 05 03 03 
03 18 13 01 04 10 11 19 04 04 04 19 14 13 16 14 05 14 15 04 
14 05 12 08 12 11 20 13 08 02 07 02 12 20 02 15 01 05 05 16 
08 08 14 01 01 01 06 17 14 13 20 20 17 03 07 20 05 07 04 12 
20 10 05 11 09 07 17 01 03 02 16 02 01 01 15 13 02 12 09 07 
04 20 06 12 14 05 11 19 11 14 02 10 04 07 13 04 05 01 17 07 
14 12 20 07 13 14 19 06 06 08 12 01 19 10 13 13 14 03 11 16 
