20 20 20
10 01 15 07 10 17 19 15 19 18 11 01 09 14 15 07 14 06 13 05 
19 10 17 04 09 09 15 18 18 01 17 07 01 04 06 02 20 04 08 18 
02 19 11 02 04 05 09 17 02 13 01 01 03 09 16 03 18 10 20 15 
02 09 01 15 12 06 16 03 02 04 20 15 14 02 16 09 07 16 05 08 
09 18 20 03 06 16 05 03 17 17 17 19 05 10 05 08 07 12 10 08 
07 01 14 20 03 10 20 01 17 05 08 17 02 20 19 07 07 04 10 15 
12 18 05 16 07 09 15 14 01 04 13 07 16 19 19 10 08 18 10 16 
14 10 13 15 09 03 14 07 06 03 13 17 12 18 04 19 18 10 04 18 
05 08 17 01 06 07 10 05 16 20 13 10 09 05 04 09 07 17 07 05 
11 19 13 03 16 09 13 14 18 08 03 03 07 11 15 13 17 16 09 13 
15 01 02 15 17 17 15 16 14 01 20 16 12 04 10 07 12 02 12 02 
09 07 16 16 17 10 20 06 17 20 10 12 01 11 18 09 19 13 04 12 
05 15 20 16 19 09 15 02 11 06 15 11 04 10 18 13 11 09 18 08 
09 07 11 01 09 08 09 07 12 13 11 17 07 10 12 17 10 06 19 12 
04 05 03 07 15 12 11 17 13 20 04 01 06 06 13 06 06 01 05 17 
05 15 13 04 16 05 12 05 02 02 09 05 07 11 04 01 14 14 09 06 
14 13 18 11 10 10 09 15 03 13 12 19 19 04 14 06 20 06 02 14 
07 10 18 13 12 13 05 06 19 14 03 12 18 01 14 07 02 14 02 04 
06 05 15 16 20 08 01 20 13 03 05 12 04 02 04 16 07 09 13 05 
14 15 16 11 07 01 17 09 15 10 04 12 14 18 08 14 06 20 05 10 
