20 20 12
01 05 07 04 09 02 10 01 04 10 10 02 04 04 08 04 01 07 10 06 
11 02 04 02 03 06 03 12 12 03 11 05 07 05 12 07 10 01 07 01 
11 09 02 02 12 02 09 12 12 11 09 03 04 05 04 06 10 10 05 01 
12 07 09 10 11 09 05 01 09 03 01 07 11 07 12 02 12 01 05 03 
11 06 05 02 10 01 11 07 10 03 11 10 01 08 07 11 04 03 03 04 
10 08 11 12 02 02 02 05 02 10 07 12 03 04 05 04 04 03 10 01 
09 09 02 09 08 01 12 11 03 02 02 04 09 04 04 02 06 09 10 11 
06 09 03 01 12 07 04 03 02 02 07 02 02 09 11 09 09 02 11 03 
07 04 07 08 12 10 09 09 06 11 07 03 07 09 03 06 08 07 12 09 
12 06 02 05 02 12 05 02 05 03 05 12 10 03 07 09 12 07 09 09 
05 04 11 03 04 02 08 11 08 11 11 07 05 01 03 10 04 07 12 01 
01 08 04 10 10 02 11 09 08 07 09 05 02 07 07 06 08 07 08 07 
09 11 05 01 03 07 11 10 01 02 02 05 01 05 03 10 06 05 10 06 
03 06 02 05 04 12 02 12 06 01 10 03 03 03 07 09 01 09 07 06 
02 08 10 02 05 04 11 10 08 12 07 03 09 08 11 01 08 12 04 05 
04 01 11 07 07 06 07 12 06 01 05 08 01 06 09 05 10 12 06 09 
11 01 11 08 08 09 08 03 12 11 08 04 03 06 02 10 03 08 09 09 
01 05 04 01 10 04 09 07 03 02 08 02 02 06 01 02 07 08 04 06 
10 03 01 12 01 06 01 07 06 01 03 06 05 10 10 07 02 10 01 08 
11 12 09 05 06 01 10 12 12 01 09 09 08 02 01 12 07 05 06 12 
