20 20 20
05 09 15 12 09 14 06 01 08 06 06 02 04 20 08 04 05 07 06 06 
15 10 04 10 07 06 19 20 20 07 15 17 15 09 20 15 14 17 15 01 
03 13 02 06 12 02 01 16 20 19 13 07 20 09 16 06 14 06 05 05 
12 11 13 18 19 13 13 05 09 19 05 11 11 19 08 14 12 01 01 03 
19 06 09 18 14 17 15 07 02 19 03 14 01 16 11 19 08 15 15 08 
06 12 19 08 10 18 02 13 18 14 15 16 19 16 05 04 12 19 10 13 
09 13 18 09 20 01 20 07 15 14 14 12 05 04 20 06 02 13 10 11 
06 17 19 17 12 03 20 03 14 10 07 14 14 05 03 13 05 14 11 11 
19 16 03 16 12 02 01 05 14 03 15 11 19 13 07 10 08 07 04 01 
08 10 06 13 14 08 17 10 13 07 01 12 14 15 07 05 16 19 01 01 
01 16 11 11 20 18 20 07 04 15 19 11 05 05 15 10 04 11 20 09 
09 12 12 02 06 10 19 01 08 19 13 01 06 03 11 06 20 03 04 15 
09 15 17 13 11 11 03 06 01 14 06 01 17 17 03 02 06 13 14 06 
03 06 18 09 20 20 06 20 02 01 06 11 07 03 15 09 05 09 15 18 
14 20 18 10 09 12 11 14 04 16 11 19 13 08 19 13 08 04 04 01 
16 09 03 03 03 18 03 20 18 17 17 12 09 06 01 17 18 04 02 13 
19 13 11 12 20 09 04 07 04 07 08 20 07 10 14 10 19 16 09 17 
05 17 08 13 02 20 01 19 03 02 04 02 14 14 05 06 15 08 12 18 
06 11 09 12 13 14 13 03 02 13 19 06 09 18 10 03 18 02 01 12 
03 16 13 09 10 09 06 04 08 17 13 13 20 14 17 04 07 01 06 08 
