20 20 20
09 03 07 13 08 01 05 03 18 08 05 08 11 19 18 05 09 12 10 17 
17 09 03 03 13 03 04 19 09 18 18 09 13 16 01 20 16 18 14 05 
05 11 13 07 09 10 04 17 13 05 14 09 14 08 03 06 10 18 17 10 
08 14 18 20 09 11 11 16 08 04 01 04 14 05 03 02 06 06 19 18 
10 04 18 03 03 20 01 05 09 17 14 16 10 04 15 10 06 05 05 13 
01 17 08 14 01 10 08 06 07 06 03 09 01 20 03 03 11 03 07 20 
19 13 15 20 08 02 09 13 18 06 17 18 02 04 12 03 06 19 20 12 
16 03 20 16 14 03 10 17 17 17 08 08 09 14 07 16 15 08 20 13 
05 16 02 06 19 13 20 04 03 20 16 10 14 07 17 19 01 07 15 18 
03 02 05 03 16 03 10 02 02 09 06 06 04 08 04 02 20 03 18 15 
14 05 16 07 11 13 06 04 19 12 01 13 06 17 15 13 11 16 14 13 
04 20 10 19 07 13 12 18 16 09 04 09 13 20 08 16 12 05 19 02 
16 11 14 01 19 20 13 09 15 19 13 10 18 03 08 16 15 19 05 02 
08 09 03 12 20 10 07 03 14 17 04 01 07 17 14 17 08 18 18 02 
16 10 03 05 04 10 20 11 08 17 12 07 17 14 11 16 15 17 18 20 
06 13 01 04 09 14 01 08 11 18 01 19 19 03 03 15 12 15 05 11 
11 08 10 19 14 20 14 08 08 03 08 13 15 20 17 15 13 09 14 15 
18 14 05 16 16 08 02 07 02 18 09 04 06 18 14 19 09 19 18 17 
01 05 09 07 16 17 13 08 05 06 15 02 19 19 10 14 18 11 12 11 
09 20 06 06 10 19 16 18 17 13 14 09 10 15 15 05 11 19 05 16 
