20 20 10
4 5 3 7 4 8 3 4 7 10 5 6 3 4 9 6 5 1 9 5 
2 5 6 1 4 4 10 6 9 7 1 3 3 5 9 6 5 4 1 1 
3 5 8 7 9 6 2 5 8 10 9 9 6 6 2 1 1 1 9 10 
9 9 2 1 6 2 8 10 5 9 2 9 5 9 5 5 6 6 9 3 
7 9 1 5 6 4 5 7 5 3 8 3 4 9 6 1 2 3 10 9 
1 1 7 8 9 4 2 6 1 1 8 8 9 10 2 5 4 8 3 10 
3 10 4 8 10 9 8 1 2 7 1 4 9 8 1 9 3 5 4 3 
5 3 2 5 2 5 1 5 3 3 6 7 4 10 4 3 8 3 6 1 
1 6 7 9 5 9 9 7 3 2 10 9 4 1 4 7 6 6 4 10 
9 9 6 4 8 1 7 8 3 4 10 5 9 6 5 6 5 3 2 9 
4 3 8 9 4 3 5 1 8 10 2 8 9 7 2 6 9 10 5 3 
3 5 7 3 10 1 8 6 3 10 7 8 4 6 8 7 8 4 9 7 
4 10 5 2 8 8 9 6 7 6 8 1 10 6 5 1 6 3 9 10 
4 7 9 7 2 6 6 1 2 6 7 5 6 3 8 5 10 8 1 8 
3 10 10 4 8 5 7 5 9 5 5 2 1 5 10 4 1 5 4 4 
1 10 8 8 5 7 2 6 6 4 6 9 6 5 4 3 1 10 7 9 
6 3 2 8 8 2 1 10 6 4 3 8 6 2 7 10 10 1 5 5 
4 2 5 1 7 9 5 9 10 2 8 6 6 1 3 5 2 4 4 10 
9 8 9 4 1 6 5 10 6 2 5 1 3 9 2 1 9 8 10 9 
9 9 6 7 9 10 1 1 5 7 2 4 4 10 9 7 7 4 6 2 
