20 20 12
09 07 11 05 12 09 01 03 10 12 01 08 11 11 06 09 09 04 02 05 
09 09 07 03 05 11 08 11 09 06 06 09 05 08 01 04 04 06 10 05 
05 03 01 07 01 06 08 09 01 01 02 09 10 12 03 02 10 02 05 10 
12 10 06 04 05 11 11 12 04 08 05 12 10 09 11 10 06 06 07 06 
06 12 06 03 03 08 09 05 01 01 02 12 10 12 03 06 02 01 05 05 
01 01 08 10 09 06 12 02 03 06 07 01 09 12 07 11 11 03 03 12 
03 09 11 04 12 06 09 01 10 06 09 10 06 04 08 03 02 07 08 04 
04 03 04 12 06 11 02 09 05 05 12 12 01 02 03 12 07 04 04 05 
01 12 06 06 03 01 12 04 11 08 08 06 02 03 09 11 05 11 07 10 
03 06 09 07 08 03 10 06 10 01 02 10 12 08 08 02 08 07 10 11 
06 09 08 07 11 05 06 08 03 04 05 09 02 05 03 01 11 04 06 09 
04 08 10 07 03 05 12 02 12 09 04 05 05 12 04 08 04 01 03 10 
04 11 06 05 07 12 05 05 03 03 05 10 10 03 04 04 07 03 09 10 
12 01 07 08 04 10 03 11 10 09 08 05 07 01 02 05 04 10 02 06 
12 06 07 01 12 10 04 11 12 05 08 03 09 02 03 12 03 05 10 04 
06 09 09 04 09 10 09 04 07 10 01 11 07 07 11 11 04 07 09 07 
11 08 02 11 02 04 10 04 12 11 08 05 07 08 09 07 05 09 02 03 
10 02 05 04 08 04 06 11 10 06 09 12 02 10 02 03 05 03 10 05 
01 05 09 11 04 09 09 08 05 10 03 02 11 07 10 06 02 03 08 03 
09 04 06 02 06 07 08 10 09 05 02 01 02 03 11 05 11 11 05 04 
