20 20 15
05 01 15 02 15 07 04 15 04 13 11 06 04 09 15 02 14 06 08 10 
14 15 12 04 04 14 10 08 13 01 02 02 01 09 11 07 15 14 13 03 
12 09 01 07 09 15 09 07 12 08 01 11 08 04 06 03 03 15 10 15 
07 04 01 15 12 11 06 03 02 04 05 05 04 12 11 04 12 11 10 08 
04 03 10 03 06 01 05 08 07 07 07 14 10 15 05 13 02 02 15 03 
12 11 14 15 08 10 10 11 12 05 03 07 07 05 09 12 12 14 05 10 
12 03 15 06 02 04 10 04 06 09 13 02 11 04 09 10 13 03 05 01 
14 15 08 05 04 08 09 07 06 13 08 02 07 08 14 09 03 15 04 08 
15 08 02 11 11 02 05 15 11 10 08 10 09 15 14 04 07 07 02 05 
11 09 13 03 01 04 03 04 03 13 03 03 12 11 05 08 12 01 14 08 
10 06 02 10 12 07 05 11 14 06 15 01 07 04 10 07 07 12 02 02 
09 12 11 06 07 15 05 11 07 10 10 02 01 11 03 04 09 08 14 07 
05 05 15 11 09 09 10 07 06 11 15 06 14 10 03 13 01 14 08 08 
09 02 01 01 04 03 04 12 02 03 11 07 07 10 02 07 10 11 14 07 
14 05 13 12 15 07 01 07 13 15 14 06 01 06 13 11 01 01 15 02 
10 10 08 09 11 10 07 05 12 12 04 10 02 01 14 01 14 14 14 11 
14 13 08 06 10 05 09 10 13 08 12 14 09 04 14 11 05 06 07 09 
02 10 03 03 02 08 10 01 14 09 03 12 13 11 09 07 07 09 02 04 
01 05 10 01 15 08 11 05 13 03 05 07 04 07 09 06 07 04 13 05 
04 15 01 01 02 01 07 09 10 15 04 02 04 13 03 04 06 05 15 10 
