20 20 12
03 03 06 12 03 03 06 06 02 04 05 03 03 12 10 05 12 06 04 12 
09 09 08 01 03 11 07 03 08 08 04 02 03 01 06 09 04 03 02 09 
06 10 11 01 01 12 05 12 10 12 03 06 12 11 06 03 09 05 09 04 
04 04 09 06 05 02 02 12 09 07 12 02 08 11 06 09 02 02 12 03 
01 03 12 01 05 10 07 01 02 03 08 05 07 04 11 03 10 04 06 06 
03 05 11 02 07 05 10 09 10 02 11 11 08 03 03 12 12 01 12 01 
07 11 05 01 06 07 07 03 03 12 12 05 09 03 10 03 11 08 03 08 
01 06 10 12 08 04 11 07 04 02 07 11 12 03 03 05 10 02 12 12 
05 03 08 01 09 05 08 07 04 10 07 08 03 04 07 10 12 09 04 07 
10 10 09 01 01 12 10 02 05 01 05 09 03 04 02 12 08 09 10 04 
06 04 03 01 12 10 10 11 06 02 09 08 03 06 08 07 05 09 12 01 
09 04 01 04 07 02 03 07 02 04 02 12 12 04 12 11 01 09 01 11 
02 09 06 09 02 05 07 10 02 07 02 02 10 03 05 09 04 11 03 10 
03 04 09 02 07 08 04 12 08 04 10 10 04 07 10 10 11 04 11 04 
10 01 06 08 07 10 04 10 01 10 07 03 01 07 08 11 02 11 10 10 
06 11 11 01 09 08 10 12 11 01 03 09 05 12 08 11 02 03 12 02 
12 07 04 04 05 03 06 07 01 04 08 06 06 06 10 03 01 08 02 03 
12 08 11 04 12 10 02 01 12 01 06 03 11 01 06 04 03 12 10 03 
07 05 12 04 02 09 10 02 08 03 08 07 11 07 02 02 08 03 02 08 
04 11 10 02 11 08 09 01 07 10 07 05 02 10 08 07 10 10 12 10 
