20 20 20
07 03 06 20 11 15 10 14 06 04 09 07 07 04 10 13 04 18 04 04 
05 17 04 09 11 19 03 03 12 16 16 10 11 13 02 13 08 03 06 05 
06 06 11 05 01 12 17 04 02 12 19 06 20 03 14 11 01 09 05 12 
16 12 13 06 05 14 18 04 09 15 20 14 12 11 10 13 14 18 08 07 
09 07 04 09 01 10 11 01 18 15 04 13 07 16 19 03 02 08 18 10 
15 17 15 18 19 05 10 13 14 10 19 03 08 15 03 08 04 05 08 01 
11 03 13 17 10 03 11 11 03 08 12 17 17 19 06 15 15 16 19 08 
17 10 02 16 04 16 03 07 20 02 07 11 04 11 19 13 14 02 16 16 
01 19 04 17 09 09 04 03 16 02 03 04 11 04 19 14 12 13 20 03 
14 06 05 09 17 04 14 02 17 01 09 17 19 04 06 08 12 09 02 20 
10 04 15 13 20 14 06 11 06 06 05 12 03 10 20 11 13 05 04 01 
05 12 09 16 15 14 03 19 14 16 10 16 12 04 08 11 17 13 13 15 
10 17 06 05 06 17 07 10 02 11 02 18 02 11 13 09 04 07 07 10 
03 16 05 14 19 12 16 08 16 08 02 06 16 19 02 14 15 08 15 08 
18 17 06 20 19 18 08 02 17 06 11 19 01 07 04 11 18 19 18 14 
18 11 11 05 01 12 18 08 19 05 15 17 13 12 08 11 02 07 04 18 
12 15 16 04 13 11 06 11 09 04 16 06 06 06 02 07 17 20 14 07 
16 20 03 08 04 02 18 05 08 01 14 11 07 01 14 20 11 20 10 19 
15 05 16 12 02 17 10 18 08 15 16 03 15 19 02 10 12 19 14 20 
20 19 10 06 19 16 17 09 15 18 19 01 02 06 12 15 14 14 04 14 
