20 20 10
5 9 5 2 9 4 6 1 8 6 6 2 4 10 8 4 5 7 6 6 
5 10 4 10 7 6 9 10 10 7 5 7 5 9 10 5 4 7 5 1 
3 3 2 6 2 2 1 6 10 9 3 7 10 9 6 6 4 6 5 5 
2 1 3 8 9 3 3 5 9 9 5 1 1 9 8 4 2 1 1 3 
9 6 9 8 4 7 5 7 2 9 3 4 1 6 1 9 8 5 5 8 
6 2 9 8 10 8 2 3 8 4 5 6 9 6 5 4 2 9 10 3 
9 3 8 9 10 1 10 7 5 4 4 2 5 4 10 6 2 3 10 1 
6 7 9 7 2 3 10 3 4 10 7 4 4 5 3 3 5 4 1 1 
9 6 3 6 2 2 1 5 4 3 5 1 9 3 7 10 8 7 4 1 
8 10 6 3 4 8 7 10 3 7 1 2 4 5 7 5 6 9 1 1 
1 6 1 1 10 8 10 7 4 5 9 1 5 5 5 10 4 1 10 9 
9 2 2 2 6 10 9 1 8 9 3 1 6 3 1 6 10 3 4 5 
9 5 7 3 1 1 3 6 1 4 6 1 7 7 3 2 6 3 4 6 
3 6 8 9 10 10 6 10 2 1 6 1 7 3 5 9 5 9 5 8 
4 10 8 10 9 2 1 4 4 6 1 9 3 8 9 3 8 4 4 1 
6 9 3 3 3 8 3 10 8 7 7 2 9 6 1 7 8 4 2 3 
9 3 1 2 10 9 4 7 4 7 8 10 7 10 4 10 9 6 9 7 
5 7 8 3 2 10 1 9 3 2 4 2 4 4 5 6 5 8 2 8 
6 1 9 2 3 4 3 3 2 3 9 6 9 8 10 3 8 2 1 2 
3 6 3 9 10 9 6 4 8 7 3 3 10 4 7 4 7 1 6 8 
