30 30 20
03 14 06 09 19 17 17 02 07 12 08 02 16 05 07 06 10 16 18 16 14 02 08 15 01 14 03 07 20 12 
10 14 17 15 14 07 04 10 08 10 13 08 11 09 12 09 14 13 05 11 20 10 04 07 04 16 13 06 02 04 
09 11 17 06 18 10 12 01 11 12 02 03 19 13 11 10 13 16 14 09 18 14 18 01 12 01 09 04 18 10 
07 07 13 15 12 02 16 15 02 06 06 15 01 16 07 11 05 20 19 11 20 16 04 18 17 07 18 05 11 08 
06 09 14 18 04 17 19 19 03 12 17 09 07 17 04 05 19 01 16 17 03 16 13 18 13 01 04 02 17 06 
01 02 15 14 12 10 02 02 08 05 06 16 05 04 12 20 08 03 12 16 19 14 03 03 11 07 15 07 08 03 
12 09 05 06 14 08 15 08 01 15 12 06 10 08 09 14 19 17 08 11 04 18 16 06 01 19 12 07 05 11 
10 16 11 06 02 17 13 08 04 13 02 07 11 04 14 19 09 12 07 16 14 10 13 10 07 05 20 18 12 04 
09 13 19 11 18 12 07 02 20 10 14 13 16 16 08 01 15 08 05 01 15 18 03 20 19 09 04 10 19 07 
13 07 19 12 09 16 15 16 09 14 17 03 19 05 10 18 05 04 06 09 17 20 19 19 19 09 19 15 19 17 
01 03 15 12 06 04 19 01 11 08 06 07 02 04 11 11 02 08 15 19 16 03 18 06 01 09 07 19 03 17 
08 15 19 02 06 05 05 17 05 15 04 02 14 05 06 04 07 19 11 01 17 19 15 14 16 15 14 14 06 16 
10 13 03 01 14 08 17 11 04 13 17 19 14 10 15 19 06 02 09 16 14 05 06 09 11 14 15 04 07 20 
12 09 04 14 09 10 13 05 20 09 17 08 07 02 18 02 13 03 15 01 10 08 06 08 08 08 01 03 03 07 
14 14 15 18 07 15 19 20 11 10 08 07 17 06 01 06 19 13 20 13 13 10 13 10 09 20 09 09 02 12 
07 16 05 14 05 04 08 03 03 19 12 02 17 08 19 17 14 18 09 13 02 14 14 14 15 14 14 04 02 15 
15 01 02 19 14 06 02 01 08 16 11 11 09 08 11 20 16 16 17 17 20 10 10 14 04 16 19 09 19 01 
15 05 13 17 16 06 14 09 18 14 17 09 04 05 08 14 16 03 01 12 11 01 14 20 06 17 08 04 17 18 
16 11 03 08 07 18 13 13 06 11 06 14 11 01 19 10 15 06 12 15 18 03 15 03 14 12 19 13 16 15 
11 11 17 13 19 16 02 11 08 19 13 13 13 15 13 03 04 19 08 08 06 17 02 12 19 07 04 09 20 19 
15 10 09 12 14 19 07 15 02 06 05 06 18 09 01 02 11 16 13 11 15 18 19 16 09 18 03 04 18 02 
14 13 03 15 16 16 13 14 02 14 19 06 12 08 07 12 01 17 19 13 19 14 10 18 09 11 07 03 06 04 
04 20 08 18 14 15 13 18 08 14 04 18 12 15 17 18 06 18 06 16 10 17 09 12 14 10 14 12 04 19 
15 20 10 15 17 15 09 10 13 09 15 16 18 18 10 15 07 07 12 13 14 13 01 15 16 14 04 09 05 19 
20 11 18 01 17 15 16 06 04 20 06 10 15 03 08 16 17 06 14 20 10 07 13 10 01 20 15 16 01 11 
15 20 02 12 12 18 06 07 15 01 06 20 03 12 03 02 07 11 07 12 11 17 19 15 06 19 14 13 15 14 
03 01 05 04 04 17 14 02 15 20 02 13 12 16 04 06 17 03 16 04 14 18 12 12 12 09 03 18 01 09 
03 04 09 08 19 12 16 04 13 10 04 07 02 15 02 18 12 11 20 07 06 05 17 17 09 08 17 11 17 18 
11 20 13 11 19 11 14 14 07 07 03 10 05 17 16 18 14 07 20 05 05 05 01 01 13 09 01 10 11 09 
19 01 08 03 03 18 05 17 11 11 03 06 12 19 02 19 08 07 17 08 11 02 12 11 14 17 12 06 06 02 
