30 30 20
05 09 15 12 09 14 06 01 08 06 06 02 04 20 08 04 05 07 06 06 15 10 04 10 07 06 19 20 20 07 
15 17 15 09 20 15 14 17 15 01 03 13 02 06 12 02 01 16 20 19 13 07 20 09 16 06 14 06 05 05 
12 11 13 18 19 13 13 05 09 19 05 11 11 19 08 14 12 01 01 03 19 06 09 18 14 17 15 07 02 19 
03 14 01 16 11 19 08 15 15 08 06 12 19 08 10 18 02 13 18 14 15 16 19 16 05 04 12 19 10 13 
09 13 18 09 20 01 20 07 15 14 14 12 05 04 20 06 02 13 10 11 06 17 19 17 12 03 20 03 14 10 
07 14 14 05 03 13 05 14 11 11 19 16 03 16 12 02 01 05 14 03 15 11 19 13 07 10 08 07 04 01 
08 10 06 13 14 08 17 10 13 07 01 12 14 15 07 05 16 19 01 01 01 16 11 11 20 18 20 07 04 15 
19 11 05 05 15 10 04 11 20 09 09 12 12 02 06 10 19 01 08 19 13 01 06 03 11 06 20 03 04 15 
09 15 17 13 11 11 03 06 01 14 06 01 17 17 03 02 06 13 14 06 03 06 18 09 20 20 06 20 02 01 
06 11 07 03 15 09 05 09 15 18 14 20 18 10 09 12 11 14 04 16 11 19 13 08 19 13 08 04 04 01 
16 09 03 03 03 18 03 20 18 17 17 12 09 06 01 17 18 04 02 13 19 13 11 12 20 09 04 07 04 07 
08 20 07 10 14 10 19 16 09 17 05 17 08 13 02 20 01 19 03 02 04 02 14 14 05 06 15 08 12 18 
06 11 09 12 13 14 13 03 02 13 19 06 09 18 10 03 18 02 01 12 03 16 13 09 10 09 06 04 08 17 
13 13 20 14 17 04 07 01 06 08 14 05 05 14 14 06 16 03 07 09 15 02 04 07 02 13 08 07 08 15 
15 13 20 14 06 16 09 12 08 15 12 01 11 08 15 04 14 02 07 20 10 01 13 14 19 14 18 06 12 18 
01 07 02 20 12 07 07 01 10 14 15 13 07 17 01 13 20 14 14 18 05 16 18 10 09 09 03 18 14 07 
07 06 13 08 17 16 06 03 08 08 09 02 20 15 10 12 19 10 05 04 07 02 19 17 11 19 05 05 17 10 
03 15 16 15 15 12 03 20 07 10 07 07 04 19 13 13 10 11 14 07 14 01 20 05 09 02 03 05 18 11 
14 01 06 01 07 20 05 09 11 11 19 10 09 02 08 01 06 17 03 20 03 08 12 02 12 20 03 15 04 01 
05 09 13 02 10 19 13 14 08 04 16 18 13 04 19 20 16 16 08 18 15 03 17 06 16 09 05 11 03 20 
03 19 01 15 13 10 13 05 15 20 20 10 17 12 05 07 03 12 03 11 01 09 05 17 15 20 05 11 10 19 
11 12 10 11 06 02 12 19 18 06 10 18 07 19 09 11 17 04 02 11 06 14 20 10 10 14 09 15 04 19 
05 06 10 14 08 16 07 19 06 05 16 15 02 02 05 02 04 02 05 17 12 10 10 11 19 20 16 08 06 20 
18 02 17 07 08 05 14 14 15 19 18 03 06 11 16 02 13 20 03 09 08 07 19 10 09 09 01 05 08 18 
16 05 19 04 04 06 20 17 12 15 08 01 09 05 12 04 06 16 03 01 04 03 07 14 12 07 03 12 03 10 
09 10 07 19 14 10 05 13 06 08 19 13 08 07 17 19 11 15 06 05 15 10 07 13 15 10 19 17 13 02 
19 13 03 17 12 16 06 08 01 03 15 19 08 02 18 04 13 08 10 18 04 04 19 11 16 14 12 15 02 05 
08 12 17 10 08 20 18 13 07 18 16 13 16 03 15 05 18 19 12 08 16 16 03 07 18 19 12 01 05 13 
05 04 05 14 13 04 13 10 17 12 07 04 04 15 18 10 19 07 08 03 06 16 10 09 02 19 19 05 19 03 
17 16 18 13 09 10 17 13 12 05 16 10 20 20 16 09 01 07 15 09 09 13 16 18 01 17 08 11 01 06 
