30 30 20
19 15 14 12 10 20 03 01 13 17 16 13 10 13 08 02 01 01 13 14 03 09 11 18 06 08 11 14 06 02 
08 04 16 01 07 06 01 09 18 05 18 13 17 07 17 17 09 17 09 13 02 11 13 04 08 19 12 10 04 17 
11 11 13 18 12 19 03 04 20 12 08 17 04 16 15 20 04 15 08 12 07 09 02 12 13 09 02 04 10 17 
12 20 07 04 18 10 03 12 05 02 04 04 10 07 20 04 19 15 11 06 07 17 15 20 20 19 01 01 14 10 
17 05 10 16 09 19 17 03 10 02 16 05 05 05 04 16 20 02 11 10 19 09 19 05 08 18 03 08 11 16 
18 19 01 19 14 01 17 11 15 06 04 10 03 08 06 06 16 17 19 06 07 17 14 17 02 13 14 16 01 16 
12 18 15 04 16 08 16 12 10 02 09 13 11 03 13 08 08 08 04 06 05 02 15 10 18 16 02 04 11 02 
19 14 11 05 09 06 13 16 09 14 17 10 19 19 12 11 06 12 10 10 17 14 11 11 03 01 18 16 04 01 
10 02 06 20 07 15 18 11 02 18 16 19 07 14 17 11 04 15 02 05 04 10 18 06 01 12 06 10 20 01 
10 09 03 16 08 01 02 05 03 03 03 18 13 01 04 10 11 19 04 04 04 19 14 13 16 14 05 14 15 04 
14 05 12 08 12 11 20 13 08 02 07 02 12 20 02 15 01 05 05 16 08 08 14 01 01 01 06 17 14 13 
20 20 17 03 07 20 05 07 04 12 20 10 05 11 09 07 17 01 03 02 16 02 01 01 15 13 02 12 09 07 
04 20 06 12 14 05 11 19 11 14 02 10 04 07 13 04 05 01 17 07 14 12 20 07 13 14 19 06 06 08 
12 01 19 10 13 13 14 03 11 16 09 04 05 04 10 09 07 06 02 03 04 15 07 04 01 11 09 20 16 06 
19 19 07 17 08 19 09 01 13 11 16 01 07 13 04 16 13 03 14 14 17 17 01 03 20 01 05 01 12 20 
06 02 19 12 19 18 02 19 11 15 02 18 07 08 02 11 15 07 05 08 20 01 17 12 16 08 05 20 08 16 
12 14 10 02 17 20 19 19 18 01 05 11 19 11 10 12 13 17 18 17 04 10 10 12 01 17 20 05 08 19 
13 19 12 02 20 01 01 11 19 10 03 03 13 13 05 02 05 18 18 02 06 14 03 07 05 04 03 16 08 11 
15 20 01 06 01 13 06 13 03 16 03 17 10 15 10 15 08 14 04 06 07 09 11 10 08 15 05 10 11 12 
12 05 04 13 02 04 05 20 09 19 07 11 15 17 17 04 03 04 09 06 01 08 06 11 09 13 18 13 15 20 
04 06 16 07 10 09 03 06 08 11 04 07 13 19 03 01 14 05 16 03 10 17 02 07 19 10 20 08 02 06 
07 17 03 02 04 13 11 18 18 10 20 14 16 04 04 10 04 17 14 19 11 15 07 12 02 18 13 13 05 14 
10 04 11 12 17 06 16 19 15 14 09 14 19 16 17 02 06 12 10 11 02 13 18 09 16 19 18 09 03 14 
02 12 17 04 15 14 01 11 12 15 16 12 08 14 20 16 07 17 07 16 07 09 08 04 09 16 14 18 04 08 
11 17 11 08 01 06 13 01 16 04 16 11 08 15 16 07 03 02 03 01 17 01 01 17 05 09 12 10 06 07 
10 17 03 20 16 15 17 08 08 12 03 15 14 10 09 01 08 03 02 10 04 11 03 04 19 19 05 10 08 10 
08 09 18 10 09 05 05 05 12 04 09 07 18 14 08 18 15 16 01 08 17 04 10 19 19 08 17 03 09 17 
05 16 05 14 06 05 19 02 02 02 05 10 20 02 15 08 11 01 03 11 09 19 06 18 10 17 18 18 19 06 
14 15 02 11 01 07 15 11 20 08 12 16 17 04 09 04 11 19 04 13 10 04 03 07 14 12 03 11 10 14 
16 15 20 17 05 20 15 12 10 06 19 14 01 08 17 09 11 07 20 06 11 01 02 13 07 15 17 02 05 06 
