30 30 15
05 01 15 02 15 07 04 15 04 13 11 06 04 09 15 02 14 06 08 10 14 15 12 04 04 14 10 08 13 01 
02 02 01 09 11 07 15 14 13 03 12 09 01 07 09 15 09 07 12 08 01 11 08 04 06 03 03 15 10 15 
07 04 01 15 12 11 06 03 02 04 05 05 04 12 11 04 12 11 10 08 04 03 10 03 06 01 05 08 07 07 
07 14 10 15 05 13 02 02 15 03 12 11 14 15 08 10 10 11 12 05 03 07 07 05 09 12 12 14 05 10 
12 03 15 06 02 04 10 04 06 09 13 02 11 04 09 10 13 03 05 01 14 15 08 05 04 08 09 07 06 13 
08 02 07 08 14 09 03 15 04 08 15 08 02 11 11 02 05 15 11 10 08 10 09 15 14 04 07 07 02 05 
11 09 13 03 01 04 03 04 03 13 03 03 12 11 05 08 12 01 14 08 10 06 02 10 12 07 05 11 14 06 
15 01 07 04 10 07 07 12 02 02 09 12 11 06 07 15 05 11 07 10 10 02 01 11 03 04 09 08 14 07 
05 05 15 11 09 09 10 07 06 11 15 06 14 10 03 13 01 14 08 08 09 02 01 01 04 03 04 12 02 03 
11 07 07 10 02 07 10 11 14 07 14 05 13 12 15 07 01 07 13 15 14 06 01 06 13 11 01 01 15 02 
10 10 08 09 11 10 07 05 12 12 04 10 02 01 14 01 14 14 14 11 14 13 08 06 10 05 09 10 13 08 
12 14 09 04 14 11 05 06 07 09 02 10 03 03 02 08 10 01 14 09 03 12 13 11 09 07 07 09 02 04 
01 05 10 01 15 08 11 05 13 03 05 07 04 07 09 06 07 04 13 05 04 15 01 01 02 01 07 09 10 15 
04 02 04 13 03 04 06 05 15 10 07 04 01 11 02 10 08 08 05 05 12 08 04 04 08 13 12 06 06 13 
13 01 14 01 14 01 11 11 06 02 05 04 12 13 06 06 14 13 05 10 09 09 02 05 04 01 02 15 13 14 
12 10 14 11 03 12 03 05 14 15 07 11 11 10 08 01 15 06 06 12 15 14 05 08 03 08 15 11 15 04 
09 11 14 08 13 01 11 08 12 10 07 03 05 02 05 04 10 11 01 15 07 07 05 11 06 15 11 05 02 10 
08 11 05 13 10 10 05 05 02 02 06 15 11 02 02 15 05 03 11 12 09 02 03 05 05 08 04 15 04 06 
09 04 08 05 01 02 14 06 13 15 14 11 07 09 12 08 01 09 02 11 05 10 04 15 14 15 07 10 14 03 
07 14 06 14 04 13 07 09 10 04 01 08 06 07 09 03 06 09 03 07 11 07 08 14 06 06 14 05 07 04 
14 13 03 04 11 13 01 09 06 03 05 06 10 10 12 03 12 02 03 14 15 13 13 07 04 10 13 09 06 11 
12 04 09 06 14 11 03 07 05 09 09 09 06 03 03 10 13 07 11 07 05 11 05 09 09 15 04 13 08 09 
09 11 13 02 02 11 12 11 02 08 11 02 01 02 05 11 11 09 02 13 07 06 15 03 07 09 02 10 06 09 
03 14 12 07 07 13 10 04 15 03 11 11 05 04 04 01 14 14 01 15 03 07 12 03 10 03 03 11 12 08 
12 07 14 08 05 05 12 14 15 03 09 03 13 13 06 01 13 04 06 13 10 09 04 06 03 05 01 05 01 04 
04 04 10 02 03 07 14 14 12 13 08 05 15 06 09 12 06 06 07 04 10 01 12 06 07 14 10 07 10 10 
02 13 13 04 07 15 10 05 05 13 09 13 03 01 10 11 12 07 09 04 10 03 11 13 08 09 11 03 07 05 
04 09 10 09 12 01 15 06 12 05 03 12 09 12 12 10 15 01 01 08 11 11 10 06 08 10 15 11 04 06 
07 07 14 01 15 10 08 15 07 11 11 02 08 11 13 04 05 12 04 05 04 06 07 06 12 07 07 03 02 10 
08 15 01 14 08 01 15 15 07 07 03 02 15 10 12 12 13 01 09 09 12 04 06 04 01 02 10 07 11 03 
