30 30 12
11 03 02 12 06 04 11 01 09 05 04 05 06 01 04 02 09 09 09 02 11 01 03 10 02 08 07 02 02 02 
08 12 04 09 03 10 01 01 02 01 10 05 05 03 09 01 05 05 01 05 10 11 09 04 08 11 12 06 04 01 
07 11 05 02 08 07 11 12 12 04 12 09 08 08 03 04 12 11 12 12 03 09 10 04 01 05 06 12 02 01 
04 08 11 08 10 10 03 12 01 02 04 04 02 11 12 04 07 03 07 06 03 09 03 04 04 07 01 09 10 02 
09 01 10 12 09 11 01 03 10 02 08 05 05 09 08 08 04 02 11 10 11 05 11 05 08 02 11 08 03 08 
10 03 09 11 02 09 09 03 03 06 08 10 03 12 10 10 12 05 03 10 03 01 02 05 06 01 06 08 09 12 
04 06 03 04 04 04 04 12 10 10 09 05 07 03 09 08 12 08 12 02 09 06 07 02 10 12 02 08 07 10 
07 02 07 01 09 10 05 04 01 06 01 02 03 11 04 11 06 08 10 06 09 06 11 03 07 01 06 12 08 05 
02 02 10 08 03 07 10 11 02 02 08 03 03 10 01 11 08 11 06 09 04 06 02 06 09 12 06 06 04 05 
10 05 07 08 12 01 06 09 03 07 11 10 01 05 12 02 03 11 12 12 08 07 06 01 04 02 01 02 11 04 
06 09 08 04 08 11 08 01 12 10 11 02 12 12 06 11 05 01 01 08 12 08 02 05 09 09 10 01 10 01 
04 08 09 03 11 08 05 07 12 04 08 10 09 07 09 03 09 05 07 10 12 10 09 05 07 09 02 08 09 03 
08 04 10 08 10 01 03 03 07 02 10 02 12 07 01 12 01 01 09 07 02 08 08 03 01 02 11 06 10 08 
08 09 03 10 05 01 10 07 03 08 01 04 09 04 10 01 03 02 06 11 12 07 11 08 09 03 01 08 08 02 
07 07 11 09 04 03 09 01 01 03 08 01 11 09 04 08 01 11 02 06 01 01 05 11 08 01 05 01 12 12 
02 10 07 12 07 02 06 07 07 07 02 06 11 12 06 03 11 11 05 12 04 05 05 12 08 04 05 12 04 04 
04 06 06 02 09 04 03 03 10 01 01 03 07 11 06 04 05 09 02 09 08 10 06 04 09 05 08 01 08 03 
09 11 08 02 12 09 05 07 11 06 11 11 01 09 01 06 01 06 02 02 06 02 03 03 05 12 07 04 12 03 
07 08 05 02 09 09 10 05 03 12 11 05 02 11 02 03 08 02 12 10 07 05 03 10 12 07 01 06 11 12 
12 05 12 05 10 08 01 12 05 07 03 03 11 05 05 12 11 12 05 10 01 04 06 03 05 05 02 05 03 04 
04 02 12 03 10 01 03 02 12 07 08 07 01 07 11 09 10 09 12 03 06 01 10 03 07 02 08 12 06 02 
03 01 07 02 04 05 03 10 06 06 08 06 12 12 04 02 08 01 10 07 07 07 11 04 10 10 09 09 09 02 
02 04 03 08 09 10 04 03 11 10 09 06 07 12 05 10 02 04 02 03 02 01 02 01 08 11 02 05 11 02 
06 12 05 12 11 02 01 03 04 11 04 04 04 10 08 12 11 01 03 12 03 05 12 04 09 12 06 02 04 08 
03 01 11 08 01 10 01 01 12 04 12 03 12 07 04 07 11 02 07 05 01 01 01 05 05 09 04 02 10 11 
02 01 11 12 12 03 01 12 08 12 07 11 06 06 05 01 04 07 02 10 12 07 03 12 03 11 01 06 12 10 
08 05 02 06 05 05 09 05 04 08 09 03 06 06 12 02 07 04 09 12 05 08 10 07 11 12 05 11 09 09 
01 04 01 06 10 09 11 10 06 06 05 02 12 10 11 12 03 09 03 11 09 07 10 06 06 01 10 02 11 06 
10 03 10 03 01 07 11 03 08 08 08 04 09 12 05 12 11 07 08 01 06 08 11 07 06 04 07 03 06 10 
08 07 04 05 09 04 03 12 06 02 07 06 05 08 05 09 07 03 08 06 07 05 06 05 11 11 01 10 01 06 
