30 30 20
07 03 06 20 11 15 10 14 06 04 09 07 07 04 10 13 04 18 04 04 05 17 04 09 11 19 03 03 12 16 
16 10 11 13 02 13 08 03 06 05 06 06 11 05 01 12 17 04 02 12 19 06 20 03 14 11 01 09 05 12 
16 12 13 06 05 14 18 04 09 15 20 14 12 11 10 13 14 18 08 07 09 07 04 09 01 10 11 01 18 15 
04 13 07 16 19 03 02 08 18 10 15 17 15 18 19 05 10 13 14 10 19 03 08 15 03 08 04 05 08 01 
11 03 13 17 10 03 11 11 03 08 12 17 17 19 06 15 15 16 19 08 17 10 02 16 04 16 03 07 20 02 
07 11 04 11 19 13 14 02 16 16 01 19 04 17 09 09 04 03 16 02 03 04 11 04 19 14 12 13 20 03 
14 06 05 09 17 04 14 02 17 01 09 17 19 04 06 08 12 09 02 20 10 04 15 13 20 14 06 11 06 06 
05 12 03 10 20 11 13 05 04 01 05 12 09 16 15 14 03 19 14 16 10 16 12 04 08 11 17 13 13 15 
10 17 06 05 06 17 07 10 02 11 02 18 02 11 13 09 04 07 07 10 03 16 05 14 19 12 16 08 16 08 
02 06 16 19 02 14 15 08 15 08 18 17 06 20 19 18 08 02 17 06 11 19 01 07 04 11 18 19 18 14 
18 11 11 05 01 12 18 08 19 05 15 17 13 12 08 11 02 07 04 18 12 15 16 04 13 11 06 11 09 04 
16 06 06 06 02 07 17 20 14 07 16 20 03 08 04 02 18 05 08 01 14 11 07 01 14 20 11 20 10 19 
15 05 16 12 02 17 10 18 08 15 16 03 15 19 02 10 12 19 14 20 20 19 10 06 19 16 17 09 15 18 
19 01 02 06 12 15 14 14 04 14 08 20 08 14 10 10 03 01 08 08 20 19 06 02 17 04 17 13 04 03 
11 14 15 04 19 18 19 13 11 02 18 19 13 05 12 02 14 07 03 14 14 14 12 12 07 08 07 03 01 11 
17 03 04 03 06 15 01 16 19 11 10 16 01 02 20 05 04 06 11 18 19 16 03 10 07 10 18 14 04 10 
16 01 04 19 03 01 05 15 17 03 18 06 18 18 19 18 14 14 03 16 03 01 04 06 02 02 15 11 07 18 
12 02 10 15 13 05 16 17 19 04 20 16 01 17 06 19 06 11 05 20 19 07 20 02 12 14 03 06 04 10 
16 16 03 05 10 15 09 17 04 20 20 03 07 20 11 12 11 17 15 07 16 13 13 08 14 05 01 08 02 04 
09 09 11 12 14 01 06 14 09 09 05 09 03 12 20 14 15 02 10 09 08 17 13 13 04 18 17 16 06 10 
20 14 19 10 17 04 02 03 09 11 03 06 11 18 17 02 11 03 16 12 04 15 08 16 07 04 14 15 19 11 
17 10 16 07 20 13 02 13 07 10 15 01 15 17 18 03 11 20 06 18 11 09 12 11 16 19 14 09 05 12 
11 01 02 07 07 13 11 08 17 09 10 04 09 16 20 07 19 02 06 16 19 09 16 11 19 11 01 12 12 05 
15 02 18 08 20 16 12 02 04 09 10 05 12 19 20 03 17 10 05 14 17 03 02 12 05 12 15 05 03 06 
02 10 19 11 17 11 06 09 12 01 09 14 05 20 04 05 14 20 06 18 05 03 13 19 14 17 10 08 14 13 
05 07 02 16 17 10 06 14 18 09 15 06 02 19 17 05 15 03 16 01 12 01 03 04 11 08 13 20 08 06 
04 04 04 05 19 12 07 04 05 04 05 19 02 18 10 10 15 04 04 10 04 16 02 18 19 12 18 11 12 05 
08 15 08 11 12 07 14 18 02 19 13 18 09 06 16 18 08 10 14 03 11 09 18 05 07 09 08 16 11 19 
20 19 06 19 01 09 17 15 18 11 05 02 08 13 20 15 03 19 16 16 01 07 04 19 03 02 07 10 17 09 
01 08 19 06 19 20 06 15 06 15 17 02 16 17 14 15 11 08 05 19 03 06 05 19 16 19 20 02 08 09 
