30 30 12
02 09 05 11 10 06 01 06 01 08 01 02 09 04 09 08 05 05 03 01 04 11 08 03 10 02 02 12 05 01 
01 07 01 09 05 10 07 10 07 07 05 07 12 05 11 08 12 07 04 02 07 07 04 06 02 05 11 03 09 04 
07 09 10 07 10 06 08 04 03 03 02 11 01 01 03 03 12 02 09 03 07 07 09 03 04 02 07 03 05 03 
10 11 04 07 10 05 04 05 08 11 07 09 09 12 09 04 02 12 09 11 02 04 05 02 06 09 04 04 03 12 
11 12 02 06 10 11 10 01 04 05 03 02 05 12 01 05 07 07 04 03 05 09 10 01 10 07 01 01 11 03 
04 01 06 06 06 03 04 07 08 11 03 10 05 07 01 09 03 07 03 06 10 11 02 07 12 03 02 04 08 04 
07 11 04 04 04 01 07 12 07 06 02 01 03 06 11 08 03 01 02 09 06 03 08 11 10 11 01 03 02 12 
10 12 11 01 04 02 05 02 05 03 07 07 03 01 12 01 08 06 01 10 07 10 04 06 12 01 04 04 07 09 
04 04 09 02 08 04 07 12 05 04 02 03 10 08 07 01 08 03 11 12 04 09 01 07 02 12 12 09 08 10 
05 11 02 05 04 01 08 02 01 04 05 06 10 06 06 05 11 05 11 09 05 02 05 09 12 10 09 11 06 08 
09 10 06 02 07 01 02 06 06 06 02 11 04 11 08 09 07 06 01 05 06 09 10 02 06 10 11 06 08 04 
01 08 06 10 01 12 02 07 05 07 12 10 09 07 09 05 07 07 02 08 12 08 08 01 09 05 10 08 10 10 
03 02 09 08 03 10 11 04 04 08 11 07 05 07 02 05 03 12 12 05 07 03 04 07 03 04 11 01 03 01 
02 06 02 10 05 09 11 04 12 02 11 02 01 03 01 06 08 03 05 11 11 04 01 06 10 07 10 12 11 12 
12 12 09 06 02 02 02 12 05 05 06 07 07 10 01 11 03 08 01 11 10 04 02 10 09 03 05 10 03 03 
02 06 07 10 03 08 11 08 07 07 01 04 01 11 01 02 09 03 01 01 02 11 04 07 12 05 10 04 06 04 
11 07 01 05 05 04 04 03 11 10 02 11 02 02 01 06 03 09 09 08 02 02 06 05 12 05 01 01 01 07 
04 11 05 05 07 09 12 10 04 10 11 05 01 04 10 01 10 05 02 10 12 03 03 05 11 02 01 12 03 05 
10 10 03 02 06 01 03 05 02 06 03 01 02 03 04 11 07 05 03 08 02 02 10 04 10 01 10 03 04 12 
07 01 09 02 06 07 06 12 11 08 09 01 08 10 07 03 01 02 08 03 09 01 09 11 05 10 11 02 04 06 
05 03 06 05 04 03 11 09 03 10 08 11 02 03 01 09 06 01 10 05 07 10 05 07 12 01 05 02 06 12 
07 10 02 04 07 09 07 05 10 01 06 05 11 08 08 03 04 05 03 05 01 02 02 05 08 02 06 04 07 03 
04 02 01 05 05 11 02 11 03 11 03 01 03 06 12 02 08 07 10 03 11 10 04 04 07 11 09 04 07 04 
06 10 05 10 06 01 08 07 12 03 09 02 07 04 11 06 09 07 12 07 09 02 08 04 05 06 06 02 01 12 
09 07 09 05 08 03 05 08 01 04 10 02 10 08 05 08 01 01 06 12 11 06 05 11 09 09 04 03 02 09 
02 10 07 03 02 02 09 07 09 01 02 10 02 03 05 06 03 09 11 08 12 01 02 04 11 02 01 07 04 06 
03 10 04 09 04 09 02 12 07 11 12 01 12 02 07 05 11 09 05 01 09 05 02 02 08 04 03 08 10 11 
02 04 08 09 12 11 09 02 02 04 04 01 08 07 06 02 03 09 03 08 09 11 12 02 12 07 06 06 07 07 
04 12 11 03 08 02 05 08 07 06 03 10 11 10 05 08 12 07 04 02 02 05 04 05 06 07 12 11 12 06 
10 08 05 08 02 04 09 11 11 04 04 02 05 06 11 01 02 02 12 09 07 05 01 10 10 11 08 09 01 08 
