30 30 12
01 05 07 04 09 02 10 01 04 10 10 02 04 04 08 04 01 07 10 06 11 02 04 02 03 06 03 12 12 03 
11 05 07 05 12 07 10 01 07 01 11 09 02 02 12 02 09 12 12 11 09 03 04 05 04 06 10 10 05 01 
12 07 09 10 11 09 05 01 09 03 01 07 11 07 12 02 12 01 05 03 11 06 05 02 10 01 11 07 10 03 
11 10 01 08 07 11 04 03 03 04 10 08 11 12 02 02 02 05 02 10 07 12 03 04 05 04 04 03 10 01 
09 09 02 09 08 01 12 11 03 02 02 04 09 04 04 02 06 09 10 11 06 09 03 01 12 07 04 03 02 02 
07 02 02 09 11 09 09 02 11 03 07 04 07 08 12 10 09 09 06 11 07 03 07 09 03 06 08 07 12 09 
12 06 02 05 02 12 05 02 05 03 05 12 10 03 07 09 12 07 09 09 05 04 11 03 04 02 08 11 08 11 
11 07 05 01 03 10 04 07 12 01 01 08 04 10 10 02 11 09 08 07 09 05 02 07 07 06 08 07 08 07 
09 11 05 01 03 07 11 10 01 02 02 05 01 05 03 10 06 05 10 06 03 06 02 05 04 12 02 12 06 01 
10 03 03 03 07 09 01 09 07 06 02 08 10 02 05 04 11 10 08 12 07 03 09 08 11 01 08 12 04 05 
04 01 11 07 07 06 07 12 06 01 05 08 01 06 09 05 10 12 06 09 11 01 11 08 08 09 08 03 12 11 
08 04 03 06 02 10 03 08 09 09 01 05 04 01 10 04 09 07 03 02 08 02 02 06 01 02 07 08 04 06 
10 03 01 12 01 06 01 07 06 01 03 06 05 10 10 07 02 10 01 08 11 12 09 05 06 01 10 12 12 01 
09 09 08 02 01 12 07 05 06 12 06 09 09 02 10 10 08 03 07 01 11 10 12 07 06 05 12 03 08 11 
07 09 12 02 10 12 05 04 08 11 08 01 11 08 03 08 06 02 11 12 02 09 01 02 07 06 10 06 12 10 
05 07 10 04 12 07 07 05 02 02 03 01 07 05 09 01 12 02 02 02 05 08 10 10 09 09 03 10 02 07 
11 10 01 08 05 04 06 11 12 12 05 02 12 11 10 12 03 10 01 08 11 10 03 01 07 03 09 01 01 02 
11 03 12 11 03 04 07 08 07 06 07 03 12 11 05 09 10 07 10 03 02 09 04 09 01 02 11 01 06 03 
02 05 06 05 07 08 01 01 07 07 07 06 01 06 04 05 06 01 03 04 03 08 04 06 04 04 07 03 04 01 
05 09 09 02 02 03 01 02 04 08 12 02 01 12 07 04 08 04 08 10 07 03 09 10 12 01 01 11 03 08 
03 11 09 11 05 10 01 05 03 04 04 02 05 04 05 03 11 04 07 07 05 05 01 01 03 12 01 07 10 07 
03 12 10 11 10 02 12 11 10 02 06 02 07 03 05 11 09 08 02 07 06 10 12 06 10 02 05 11 08 03 
09 02 02 06 04 12 11 03 02 09 08 07 10 02 01 06 04 10 01 09 04 06 06 03 11 04 08 04 06 04 
10 06 09 11 04 01 02 02 07 03 10 07 02 11 12 06 05 04 03 09 04 11 03 02 05 05 09 01 12 06 
08 09 11 08 12 02 12 01 08 07 08 09 05 01 08 04 06 04 07 01 12 03 11 06 04 07 11 12 11 10 
05 10 11 07 06 10 09 05 10 08 03 05 04 07 05 11 11 03 06 09 03 06 11 05 03 06 11 01 09 10 
03 05 11 05 12 04 02 12 01 03 07 03 12 10 02 04 01 12 10 06 12 12 03 11 04 06 08 03 10 05 
04 04 09 02 08 12 10 09 11 10 12 09 12 11 07 05 06 11 04 04 04 04 07 11 06 11 08 05 05 05 
09 12 09 10 01 08 09 10 05 12 07 08 08 11 10 06 03 07 04 11 02 12 06 09 10 03 11 09 07 03 
01 08 06 01 05 06 09 05 08 05 08 06 04 04 08 05 01 03 11 05 01 05 08 06 01 05 12 03 01 06 
