30 30 20
14 05 13 07 14 18 13 14 17 20 05 06 13 04 09 16 05 01 19 05 12 15 16 11 14 14 10 16 09 17 
01 03 13 05 09 06 15 14 11 11 13 15 08 17 19 16 12 15 08 10 19 19 16 06 02 01 11 11 09 20 
19 09 02 11 06 02 08 20 15 19 02 19 05 09 15 15 16 06 09 03 07 19 01 15 16 14 15 07 05 03 
18 03 04 19 06 01 12 13 20 19 11 01 17 08 09 04 02 16 01 11 18 08 09 10 02 05 04 08 03 20 
03 20 14 18 10 19 18 01 12 17 11 14 09 08 01 09 03 15 04 03 05 13 02 05 02 15 01 05 03 03 
16 17 14 10 14 03 08 03 16 11 11 06 17 19 05 09 19 07 03 02 10 19 14 11 04 07 06 16 04 20 
19 19 16 04 08 01 07 08 03 14 10 05 19 06 15 16 15 13 02 09 14 03 08 19 14 03 05 11 18 20 
02 08 19 17 12 06 09 10 05 03 03 15 07 13 20 01 08 06 13 10 07 18 04 06 08 17 08 04 19 17 
04 20 05 02 08 08 19 16 17 16 18 11 10 16 15 01 16 03 19 20 04 17 09 07 02 16 16 01 12 06 
17 15 06 13 08 05 20 18 01 08 13 10 10 14 18 05 07 05 19 05 05 02 01 05 20 14 01 15 14 04 
01 10 18 18 15 17 02 06 06 14 06 19 16 15 04 13 11 10 17 09 06 13 02 18 18 02 11 10 16 04 
13 08 06 02 17 20 10 11 05 15 04 02 05 11 17 09 15 19 10 12 08 16 16 01 13 05 02 04 14 10 
19 18 09 04 11 06 15 20 16 12 15 11 13 19 02 01 19 08 20 09 19 19 16 07 19 20 11 01 15 17 
02 14 14 10 09 17 07 04 16 02 15 02 05 07 13 18 08 11 05 19 11 16 17 18 02 07 18 04 19 12 
20 20 17 06 02 06 02 08 09 09 02 15 11 18 13 15 15 20 05 11 10 08 06 06 05 19 13 14 03 11 
18 14 03 14 11 04 19 04 11 19 13 04 13 15 01 06 09 15 17 05 06 07 12 03 04 09 02 16 14 16 
19 11 01 01 05 12 16 03 15 06 14 07 10 06 13 02 11 01 17 20 18 14 06 09 08 09 09 01 17 03 
16 15 05 17 07 09 20 02 04 14 19 17 13 20 14 05 02 17 18 10 16 15 15 01 15 02 01 04 03 09 
18 10 03 02 18 01 03 17 14 06 11 13 14 03 12 07 19 05 03 16 14 18 10 08 10 17 02 03 12 04 
11 09 13 06 02 03 18 16 19 12 13 09 04 06 03 07 05 02 12 07 17 17 17 19 05 18 15 06 12 18 
01 15 06 05 20 19 07 17 15 06 20 07 06 03 05 09 10 09 10 13 07 18 09 15 08 05 13 14 02 16 
11 02 10 08 19 01 07 05 10 13 02 09 19 08 12 15 16 13 03 17 17 02 14 05 16 02 10 20 07 03 
16 18 05 05 05 15 06 11 19 15 15 13 03 06 12 06 20 19 10 15 15 06 16 20 03 11 13 04 03 20 
06 18 17 02 14 13 16 19 04 07 05 18 11 20 15 02 17 15 20 07 09 06 04 16 05 18 18 18 13 20 
09 19 17 17 12 11 09 20 01 12 06 18 02 08 17 16 09 13 02 08 11 02 05 07 17 09 04 15 18 09 
14 06 19 03 02 10 05 11 09 17 14 06 14 07 13 10 15 13 15 16 12 17 18 16 03 06 05 19 20 14 
07 06 20 05 20 13 06 04 15 15 20 01 12 14 19 05 15 13 09 01 01 01 18 10 16 12 15 20 10 07 
14 08 12 05 12 11 09 18 06 04 04 05 16 07 10 14 03 17 19 12 17 19 12 06 08 07 18 14 19 19 
20 04 07 03 08 10 05 08 19 10 03 02 07 18 09 08 12 11 04 10 02 13 20 05 18 19 12 15 12 10 
06 04 13 12 18 12 01 15 19 20 04 02 13 02 19 13 10 02 16 05 03 09 17 02 14 07 12 05 13 04 
