30 30 15
14 15 14 12 15 10 08 01 03 02 01 08 15 13 13 02 06 06 03 14 08 04 06 13 11 08 01 14 11 02 
08 09 01 06 12 01 01 04 08 10 13 08 02 12 12 07 14 02 04 08 07 11 03 04 08 14 12 15 04 07 
01 11 08 08 02 04 08 09 15 07 03 12 14 11 15 10 09 05 03 12 12 09 07 07 13 14 12 09 05 07 
07 05 02 14 13 10 03 12 10 02 04 04 05 02 15 04 04 15 01 06 12 12 15 10 10 04 01 06 04 05 
12 10 10 06 09 14 07 03 10 02 11 05 05 15 14 11 10 02 11 10 14 14 14 05 08 08 08 08 06 11 
13 09 06 14 14 06 12 06 15 06 14 10 03 03 01 01 06 02 09 01 12 07 14 02 12 13 09 11 06 06 
07 03 15 04 01 13 01 12 10 07 09 08 01 03 03 08 03 08 09 11 15 12 10 05 13 06 02 14 01 07 
04 14 01 10 09 01 08 01 04 09 07 05 09 14 07 11 06 02 10 15 12 09 11 06 13 01 03 06 14 11 
05 02 01 05 12 10 13 11 02 08 11 09 12 04 07 11 14 05 12 15 04 15 08 06 06 12 06 15 10 11 
10 14 13 11 03 01 12 15 03 13 08 13 13 11 09 05 06 14 09 09 14 04 09 13 01 14 10 14 05 04 
09 15 02 13 02 11 05 13 03 07 02 02 12 15 12 05 11 10 10 11 03 08 14 11 06 06 01 07 04 13 
10 05 12 03 02 05 05 07 09 07 05 10 15 01 09 12 12 11 13 07 06 07 06 11 10 03 02 02 09 12 
14 10 01 02 04 10 06 09 01 14 07 05 09 07 13 09 10 01 12 07 14 02 05 12 13 14 14 06 01 08 
02 06 09 10 08 13 04 13 06 11 04 04 15 04 10 04 12 11 12 08 09 10 02 14 06 06 04 05 11 11 
04 04 02 12 13 09 09 01 13 06 11 01 02 03 04 11 13 08 14 09 07 07 11 08 05 01 05 01 12 15 
11 07 04 12 04 08 12 04 01 10 02 03 02 03 12 06 05 02 05 03 10 11 02 12 11 13 05 15 13 01 
07 09 15 02 12 10 09 09 13 01 10 06 04 11 15 07 08 12 08 12 14 10 15 07 06 02 05 10 08 09 
03 14 02 02 15 06 11 01 14 15 08 08 13 03 10 12 10 03 08 02 06 14 03 12 05 09 13 01 03 06 
10 05 11 11 06 03 01 08 03 06 08 02 05 05 05 15 08 14 09 01 07 14 06 10 03 10 10 15 11 12 
12 05 09 08 07 14 10 15 14 04 12 06 05 02 02 09 08 09 14 01 01 13 06 06 14 08 08 08 15 10 
04 11 06 12 10 04 03 11 03 01 14 07 13 04 08 06 04 15 06 03 15 07 07 12 04 05 05 03 12 11 
12 07 13 02 04 08 06 13 03 15 05 09 06 09 04 05 14 07 04 04 01 10 02 07 07 13 03 03 15 14 
05 04 06 02 12 01 01 09 05 04 09 09 04 06 02 07 11 07 05 06 02 13 08 04 11 14 08 14 08 14 
12 12 02 09 05 14 01 06 07 05 01 07 13 04 05 06 02 07 12 06 12 14 03 04 09 06 09 08 04 08 
06 07 11 08 01 01 13 01 06 04 06 06 03 10 01 07 08 02 13 11 07 01 01 02 05 09 07 05 01 02 
05 07 08 15 06 15 07 03 08 12 13 05 09 15 14 01 13 13 02 10 09 01 03 09 09 14 10 15 03 10 
08 14 08 15 14 05 15 05 07 14 09 12 03 09 03 08 10 01 06 03 02 14 10 04 14 03 02 08 09 12 
10 01 10 09 01 15 14 07 12 12 05 05 15 07 05 03 06 06 03 11 09 04 01 03 15 07 13 08 14 06 
04 15 07 06 01 07 05 06 05 08 02 01 12 09 14 09 11 04 14 13 15 14 08 07 09 07 13 06 15 04 
11 10 10 02 15 10 15 12 15 11 04 09 11 08 02 09 01 12 05 06 01 11 12 08 02 05 07 07 10 06 
