30 30 12
03 03 06 12 03 03 06 06 02 04 05 03 03 12 10 05 12 06 04 12 09 09 08 01 03 11 07 03 08 08 
04 02 03 01 06 09 04 03 02 09 06 10 11 01 01 12 05 12 10 12 03 06 12 11 06 03 09 05 09 04 
04 04 09 06 05 02 02 12 09 07 12 02 08 11 06 09 02 02 12 03 01 03 12 01 05 10 07 01 02 03 
08 05 07 04 11 03 10 04 06 06 03 05 11 02 07 05 10 09 10 02 11 11 08 03 03 12 12 01 12 01 
07 11 05 01 06 07 07 03 03 12 12 05 09 03 10 03 11 08 03 08 01 06 10 12 08 04 11 07 04 02 
07 11 12 03 03 05 10 02 12 12 05 03 08 01 09 05 08 07 04 10 07 08 03 04 07 10 12 09 04 07 
10 10 09 01 01 12 10 02 05 01 05 09 03 04 02 12 08 09 10 04 06 04 03 01 12 10 10 11 06 02 
09 08 03 06 08 07 05 09 12 01 09 04 01 04 07 02 03 07 02 04 02 12 12 04 12 11 01 09 01 11 
02 09 06 09 02 05 07 10 02 07 02 02 10 03 05 09 04 11 03 10 03 04 09 02 07 08 04 12 08 04 
10 10 04 07 10 10 11 04 11 04 10 01 06 08 07 10 04 10 01 10 07 03 01 07 08 11 02 11 10 10 
06 11 11 01 09 08 10 12 11 01 03 09 05 12 08 11 02 03 12 02 12 07 04 04 05 03 06 07 01 04 
08 06 06 06 10 03 01 08 02 03 12 08 11 04 12 10 02 01 12 01 06 03 11 01 06 04 03 12 10 03 
07 05 12 04 02 09 10 02 08 03 08 07 11 07 02 02 08 03 02 08 04 11 10 02 11 08 09 01 07 10 
07 05 02 10 08 07 10 10 12 10 12 08 08 02 06 10 03 01 12 08 08 07 06 10 01 04 05 09 08 03 
07 06 11 12 03 10 07 01 07 06 02 07 05 09 08 10 06 03 11 10 10 10 04 08 11 04 03 03 01 11 
09 11 04 11 10 11 09 08 03 03 06 04 01 10 12 01 08 10 03 10 07 04 11 10 11 10 02 02 04 06 
04 01 08 07 11 09 09 11 05 11 06 10 02 06 11 02 10 10 11 04 11 05 12 10 06 02 07 11 07 10 
08 10 02 03 09 05 12 05 03 08 04 08 09 05 06 07 10 07 09 12 03 07 04 02 04 02 03 10 12 10 
12 08 11 01 10 07 05 01 04 12 08 07 11 04 03 04 03 01 03 03 12 05 09 08 06 01 09 12 02 08 
01 05 07 12 06 05 06 02 09 09 05 05 07 04 12 10 11 06 10 01 08 01 09 09 08 06 09 08 06 02 
04 06 07 10 09 04 06 03 09 03 03 06 11 02 09 02 11 11 12 12 04 11 12 12 07 12 06 07 07 03 
01 02 12 11 12 09 06 09 03 02 03 09 07 05 10 07 11 12 06 02 11 09 12 03 12 07 02 05 05 08 
11 05 10 11 03 01 11 08 01 05 02 08 01 12 12 11 07 02 10 04 03 01 04 03 03 03 01 04 12 05 
03 10 02 04 12 08 08 02 04 09 06 09 04 07 08 07 09 06 09 10 01 11 10 04 05 04 11 05 07 10 
02 02 11 07 05 03 02 01 04 09 01 02 05 04 12 01 02 08 10 10 09 11 01 11 02 05 02 12 02 09 
01 07 10 04 01 06 06 06 06 01 03 06 02 07 01 01 11 07 12 09 08 09 07 08 11 12 05 12 04 06 
12 08 04 09 11 08 07 04 01 12 09 03 10 02 02 02 07 12 12 06 08 08 06 06 03 04 10 07 04 01 
04 03 08 07 04 07 06 10 02 07 01 02 01 02 04 02 08 10 06 11 07 05 06 05 11 01 12 12 11 03 
12 03 10 11 01 05 09 07 06 03 05 10 04 05 04 11 11 03 12 04 01 07 08 07 03 10 07 02 09 09 
09 12 03 06 03 04 02 11 02 11 05 10 08 01 02 11 11 04 05 03 07 06 09 07 04 03 04 10 04 05 
