30 30 15
10 14 10 07 09 14 01 01 13 01 01 02 04 10 08 04 10 07 01 06 05 05 04 05 12 06 09 15 15 12 
05 02 10 14 15 10 04 07 10 01 08 03 02 11 12 02 06 06 15 14 03 12 10 14 01 06 04 01 05 10 
12 01 03 13 14 03 08 10 09 09 10 01 11 04 03 14 12 01 11 03 14 06 14 08 04 07 05 07 07 09 
08 04 01 11 01 14 13 15 15 13 01 02 14 03 05 08 02 08 08 04 10 06 09 01 05 04 07 09 10 13 
09 03 08 09 05 01 15 02 15 14 14 07 15 04 10 11 12 03 10 11 06 12 09 07 12 13 10 03 14 05 
07 14 14 15 08 03 15 14 11 06 04 01 13 11 12 07 06 15 09 08 10 06 04 03 12 15 08 07 09 06 
03 15 11 08 14 03 02 05 08 12 11 12 04 15 07 15 06 04 06 06 11 01 11 06 10 08 05 02 14 05 
14 01 05 10 15 10 04 01 15 04 04 02 07 07 01 05 14 06 08 04 03 11 11 13 01 06 05 13 14 10 
09 05 02 13 06 01 08 01 01 14 11 11 07 02 03 07 06 08 04 06 03 06 08 14 10 15 11 15 12 01 
01 06 12 03 10 09 10 09 10 03 14 05 13 05 14 07 11 04 14 06 01 09 03 08 14 13 08 09 04 11 
01 04 08 13 13 03 13 15 03 07 02 02 04 06 06 02 13 09 12 03 14 13 11 02 05 09 14 12 09 02 
08 10 12 15 14 10 09 11 09 12 10 02 13 13 07 10 06 04 03 02 14 02 14 09 10 11 10 08 07 03 
01 06 04 12 13 09 13 13 12 13 09 06 14 13 10 13 08 07 01 02 08 06 03 14 15 04 01 09 03 07 
03 03 05 14 07 09 07 11 06 03 09 15 15 14 04 01 11 03 07 04 05 07 09 07 12 08 03 12 08 05 
10 03 15 14 01 06 14 07 08 05 02 01 11 08 15 14 09 02 02 15 05 06 13 14 04 09 13 06 12 13 
11 07 07 10 12 07 07 11 05 14 15 13 07 02 06 13 15 14 14 08 05 11 13 10 09 09 03 13 14 07 
02 01 13 08 02 01 06 08 03 03 14 02 15 05 10 12 09 10 10 14 02 07 09 07 01 09 15 10 07 05 
08 15 06 05 15 07 13 05 07 15 07 12 09 14 08 03 10 01 04 12 14 06 10 15 04 02 08 10 03 06 
14 11 06 11 07 05 10 04 01 01 04 15 04 12 13 11 06 07 03 10 03 08 07 12 07 10 13 15 04 01 
05 09 03 02 05 09 13 14 13 14 06 08 13 09 04 10 11 01 08 13 10 03 12 01 06 04 10 11 03 05 
03 14 06 05 08 10 13 05 15 10 10 05 02 07 05 12 08 07 13 01 11 14 10 07 15 15 10 01 10 04 
06 12 10 11 01 02 12 14 13 11 15 08 07 09 14 11 12 14 02 01 06 04 15 15 10 14 14 05 14 09 
15 11 05 09 13 06 02 09 11 15 11 10 07 02 10 12 04 07 10 12 07 15 15 06 14 10 11 13 06 10 
13 12 12 02 13 10 14 14 10 09 13 13 11 11 06 12 08 10 03 09 13 02 09 05 14 14 06 10 03 03 
11 15 14 14 09 11 15 07 02 10 08 06 14 10 02 04 06 01 13 01 09 03 02 09 07 07 08 12 08 10 
14 10 02 04 09 10 15 08 01 08 09 08 13 07 02 14 11 15 06 15 15 15 02 08 15 15 14 07 03 07 
09 08 08 02 12 01 11 03 01 03 10 09 03 07 08 04 13 03 10 03 09 09 09 11 01 09 02 15 07 05 
13 07 12 05 08 15 13 03 02 13 06 03 06 08 10 05 03 14 07 13 01 01 13 02 03 14 02 11 05 08 
15 09 15 04 13 14 03 10 02 12 07 14 14 05 13 15 09 07 13 08 11 06 15 09 07 09 14 15 04 03 
07 11 03 13 14 15 12 08 02 05 11 15 10 10 11 14 01 12 05 14 04 08 11 03 01 02 03 06 01 06 
