30 30 15
08 14 11 14 04 07 12 07 12 07 13 02 06 15 12 01 15 06 03 11 04 12 13 15 06 14 08 07 10 12 
10 09 02 05 14 12 04 10 03 15 08 08 01 14 07 04 14 13 10 01 15 05 04 12 04 01 03 11 07 04 
14 01 12 01 13 10 12 01 11 07 07 03 14 08 01 05 03 06 09 04 13 09 08 01 12 11 09 14 13 15 
02 12 08 05 12 12 06 15 12 01 06 10 11 11 02 11 15 05 09 01 15 06 09 08 07 12 03 15 11 08 
06 04 04 13 09 07 09 14 13 12 07 04 07 02 14 15 04 06 11 12 13 11 03 13 03 01 09 12 07 11 
11 12 15 14 02 15 12 02 13 10 06 11 05 04 12 10 03 08 07 06 04 04 08 13 01 02 05 02 13 03 
12 09 15 11 14 08 10 03 01 15 12 06 10 08 09 14 09 12 13 01 09 08 11 01 06 04 02 02 05 06 
05 01 06 11 12 12 03 13 14 03 12 02 01 14 09 09 04 02 12 01 09 05 08 05 12 05 15 13 07 04 
04 03 04 01 13 07 12 07 05 10 09 08 11 01 13 11 10 08 05 06 15 13 03 15 09 14 04 15 04 02 
03 07 04 07 14 01 05 11 14 09 12 08 09 15 15 13 10 09 06 14 07 05 04 09 04 04 14 15 04 02 
01 13 15 12 11 14 04 01 01 03 01 12 02 09 11 01 07 13 10 04 11 08 08 06 01 04 02 14 03 12 
08 10 09 07 06 05 05 02 05 05 04 12 09 05 06 04 12 04 01 06 07 04 05 14 01 05 09 09 11 11 
05 03 13 06 09 03 02 06 04 13 02 14 09 10 10 14 06 07 09 06 04 15 01 09 06 09 05 14 02 15 
02 14 09 14 04 10 08 05 15 04 02 08 02 02 03 12 08 08 10 01 05 13 01 13 13 13 06 03 03 07 
09 04 05 03 02 15 04 10 11 10 13 12 02 06 06 11 09 13 10 03 13 15 08 05 04 05 09 09 07 12 
07 01 15 04 10 09 03 13 03 14 07 07 02 08 04 07 04 13 04 13 07 09 04 14 05 14 04 14 07 10 
10 06 02 09 09 11 02 11 08 11 01 06 09 03 06 05 01 01 02 12 05 15 05 09 14 01 14 09 14 06 
10 15 03 12 01 11 14 09 13 14 12 14 04 05 08 09 01 08 01 02 11 06 09 15 06 07 08 04 07 13 
01 01 13 03 12 13 13 03 06 11 01 09 01 11 14 15 05 06 07 05 08 03 10 08 09 07 14 08 11 05 
06 11 12 03 14 01 07 11 03 04 13 03 13 05 13 03 04 09 08 03 06 07 12 07 14 12 14 04 05 09 
15 10 04 12 04 09 12 10 12 06 05 01 08 09 06 12 11 01 13 11 10 03 09 06 09 08 03 14 03 07 
14 03 08 10 06 11 03 09 12 14 14 01 07 13 02 12 01 12 04 13 14 14 15 08 04 01 07 13 06 09 
04 05 03 03 14 15 13 08 08 09 14 13 02 05 02 03 01 03 06 11 15 12 09 07 04 05 14 02 09 04 
10 05 15 05 07 05 04 05 13 04 05 11 08 13 15 10 07 07 12 13 09 03 01 10 01 04 14 14 05 14 
10 06 03 01 02 10 06 06 14 10 01 10 05 08 08 11 02 06 09 05 10 02 08 10 11 15 05 01 06 01 
15 15 07 02 07 08 11 12 05 01 06 05 03 02 13 02 12 06 07 12 11 02 14 10 11 09 09 08 10 14 
08 01 05 14 09 12 14 12 15 10 12 13 07 06 14 11 07 03 01 14 14 03 07 12 12 09 13 13 01 14 
03 09 14 08 14 07 11 04 03 10 14 07 07 05 12 13 07 11 15 07 01 05 02 07 09 13 07 06 02 08 
11 05 08 01 04 06 14 14 02 02 08 15 15 07 11 03 04 02 05 10 15 05 06 01 03 14 06 10 11 14 
09 06 03 08 13 13 05 12 11 06 13 11 12 04 02 14 13 12 07 03 06 07 07 11 14 02 02 11 11 12 
