30 30 12
02 01 03 11 06 01 07 03 07 10 11 09 01 06 03 11 02 06 05 01 11 06 09 04 01 05 07 02 10 01 
05 11 01 12 02 10 12 08 04 06 06 03 07 10 12 09 09 01 06 05 01 05 11 01 12 03 06 06 04 03 
10 01 01 03 12 02 12 03 02 04 08 11 10 06 08 01 03 08 01 08 01 06 04 03 06 04 05 11 01 01 
01 11 01 06 05 04 11 08 06 12 03 05 02 12 11 10 04 05 09 05 12 01 10 08 03 03 03 08 02 07 
12 06 09 12 11 01 07 10 09 12 01 11 08 07 03 10 04 06 02 04 02 06 05 11 01 11 06 07 06 07 
05 05 04 02 08 03 06 06 04 02 09 08 05 05 02 11 02 09 08 04 05 10 09 09 08 01 07 01 11 05 
11 03 01 03 04 01 09 10 06 04 03 03 03 11 11 05 09 04 05 05 07 09 02 07 09 01 11 08 02 09 
12 04 04 04 10 07 04 06 08 02 09 03 08 12 01 06 08 02 01 04 10 08 01 11 06 01 03 05 08 04 
05 11 12 08 03 09 07 10 03 02 03 03 08 10 06 01 07 05 02 08 09 11 07 01 01 12 01 03 08 09 
11 01 07 10 08 01 10 02 11 04 08 05 07 03 03 04 07 01 01 12 08 09 10 06 01 02 10 01 09 05 
01 07 05 12 08 01 04 05 06 06 01 01 11 07 08 01 02 02 05 02 02 01 02 03 10 02 09 07 07 05 
12 11 03 04 02 02 08 06 10 06 11 10 06 09 08 05 01 10 11 06 03 12 10 05 06 07 10 06 02 04 
10 05 07 04 12 08 05 08 01 03 05 04 04 10 12 12 07 01 01 05 10 03 04 07 11 01 01 09 07 06 
04 08 10 10 12 10 06 08 09 10 10 01 01 02 02 01 05 08 05 05 12 02 07 07 08 10 12 12 06 10 
10 01 05 07 11 04 08 08 12 08 05 01 12 10 06 06 02 10 05 10 06 09 11 05 07 10 02 06 01 11 
03 10 11 08 09 09 03 08 08 06 04 05 11 07 02 04 12 03 06 09 12 11 05 02 03 11 03 08 09 07 
06 11 05 05 10 01 05 05 12 01 10 03 05 08 02 10 04 05 04 09 01 07 11 05 12 06 08 02 05 04 
08 11 02 04 07 04 08 11 08 08 03 09 02 11 05 03 08 12 08 03 12 08 09 02 05 08 07 12 01 12 
03 01 02 08 04 08 11 12 10 06 11 05 07 12 03 11 07 03 02 02 05 01 01 06 02 09 01 01 08 06 
04 02 06 05 10 01 04 12 04 01 10 02 09 04 06 12 06 12 06 07 05 10 11 05 03 12 02 08 04 01 
05 07 03 10 11 04 10 06 03 06 11 12 07 07 03 12 06 08 03 11 06 07 01 04 04 07 04 09 06 11 
09 10 06 03 11 08 06 01 02 09 06 12 12 12 06 07 04 04 02 10 02 08 05 06 03 12 01 10 08 06 
09 08 04 02 11 02 09 08 02 02 08 11 01 08 11 11 02 06 02 07 07 03 06 03 01 09 02 01 06 09 
06 02 09 01 07 07 07 04 06 12 05 02 11 10 01 01 08 02 10 09 12 04 03 06 07 03 06 08 03 11 
09 01 05 05 05 11 03 11 06 12 03 03 01 01 12 01 01 07 06 10 07 06 01 09 03 11 04 08 07 10 
10 07 10 02 03 07 05 05 09 10 08 11 12 09 03 03 09 03 01 07 04 07 12 09 04 02 07 07 01 01 
08 10 07 10 04 09 04 08 05 04 09 01 03 01 01 05 03 01 12 04 07 03 02 10 11 09 11 06 07 11 
10 03 01 09 12 04 09 03 03 02 06 03 06 12 03 10 09 10 10 08 05 05 10 06 02 01 03 05 10 09 
07 07 11 07 03 10 02 12 04 08 05 02 11 02 01 01 11 09 10 08 04 06 04 06 12 10 10 06 02 07 
02 12 01 05 11 04 06 12 07 10 12 11 03 10 12 03 10 10 12 12 09 07 09 01 04 08 10 01 05 03 
