30 30 15
12 03 06 15 06 15 15 09 11 04 14 12 12 09 10 08 09 03 04 09 15 12 14 04 06 14 13 03 02 11 
01 05 06 13 12 03 13 03 11 15 06 01 11 10 01 12 02 09 07 12 09 06 15 08 09 06 06 14 15 07 
01 07 03 06 05 14 08 09 09 10 15 14 02 11 15 03 14 08 03 12 04 12 09 04 11 10 01 01 08 15 
14 08 07 01 14 03 07 13 03 15 15 02 05 08 04 05 10 03 04 05 14 08 08 15 03 03 09 10 03 01 
01 08 08 07 15 13 01 06 03 03 12 02 12 09 01 15 05 11 09 08 07 15 07 06 14 01 08 07 10 02 
07 11 09 06 09 08 04 02 06 06 11 09 14 07 09 14 14 13 01 07 13 14 06 04 04 04 12 03 10 13 
04 01 15 04 07 09 04 02 02 01 14 12 09 04 11 03 02 09 07 10 15 04 15 13 15 04 01 11 06 11 
15 02 03 15 05 01 08 15 09 01 15 07 04 01 10 14 03 04 14 01 05 06 12 04 03 11 07 03 13 05 
05 12 06 15 11 02 07 10 02 01 02 08 07 06 08 09 04 02 12 10 03 01 15 14 04 02 01 03 11 13 
07 01 01 04 07 04 05 13 05 13 13 07 06 05 04 13 13 07 07 01 01 09 01 07 14 11 08 14 13 04 
03 11 11 10 06 02 13 03 14 10 15 12 08 12 08 11 02 12 09 08 12 10 01 04 08 06 06 01 04 04 
11 06 06 06 07 12 07 05 14 12 06 05 08 13 09 07 08 10 03 01 09 06 02 01 09 10 06 15 10 09 
10 05 06 07 02 12 10 08 08 15 11 13 05 04 02 05 02 09 14 05 10 14 10 11 14 11 12 04 10 13 
04 11 02 01 02 10 04 04 09 04 03 05 08 14 15 10 03 01 03 08 05 04 06 07 07 04 02 03 14 03 
01 09 05 09 09 13 04 13 01 12 08 04 08 15 02 07 09 12 08 04 04 04 07 02 02 13 12 03 01 11 
12 08 04 08 01 05 06 11 09 06 15 01 01 07 15 10 14 01 06 13 04 01 08 10 02 10 08 14 04 15 
01 01 14 04 08 06 15 05 02 08 03 01 08 03 14 08 04 04 08 01 08 11 09 01 12 02 10 11 07 13 
02 07 05 15 03 05 06 02 09 14 10 11 06 02 06 04 01 01 15 15 09 07 10 02 07 14 03 01 09 10 
06 11 08 10 10 10 14 07 04 15 05 13 02 10 06 07 06 07 15 12 06 08 03 08 09 10 06 03 02 14 
04 14 01 12 09 11 06 14 09 09 05 14 13 07 15 04 05 12 10 04 08 07 03 03 14 03 12 11 06 05 
10 09 04 10 12 04 12 03 09 06 03 06 11 08 12 02 11 08 06 12 04 05 03 06 07 09 09 10 04 06 
07 05 06 02 15 03 12 03 12 05 15 06 10 02 13 13 11 15 06 08 11 09 12 06 06 04 14 14 05 02 
11 11 07 02 12 13 11 08 07 14 05 14 04 06 15 02 04 02 01 01 09 04 01 06 09 06 01 07 12 05 
15 07 08 13 15 11 02 02 04 09 15 15 07 04 05 13 12 15 15 04 07 08 07 07 05 07 05 05 13 01 
02 05 14 01 02 06 11 04 07 06 04 14 05 10 09 10 14 05 01 13 15 08 13 14 14 02 05 03 14 03 
10 07 07 01 07 15 06 09 03 04 15 06 02 04 07 10 05 13 06 06 02 06 13 14 11 03 08 15 13 06 
09 14 04 15 14 02 07 04 10 09 15 09 07 08 05 05 10 09 09 15 14 11 12 03 09 07 13 01 07 10 
13 15 08 01 07 07 09 13 02 04 13 08 04 11 01 08 08 10 09 08 01 14 03 05 02 04 03 06 11 09 
15 09 01 14 01 14 12 10 03 06 05 07 13 08 10 05 08 09 06 01 01 07 14 04 03 07 07 05 12 09 
06 03 09 06 09 10 11 05 11 05 02 07 11 07 14 05 11 13 05 09 13 06 15 04 01 09 10 07 13 14 
