30 30 20
09 03 07 13 08 01 05 03 18 08 05 08 11 19 18 05 09 12 10 17 17 09 03 03 13 03 04 19 09 18 
18 09 13 16 01 20 16 18 14 05 05 11 13 07 09 10 04 17 13 05 14 09 14 08 03 06 10 18 17 10 
08 14 18 20 09 11 11 16 08 04 01 04 14 05 03 02 06 06 19 18 10 04 18 03 03 20 01 05 09 17 
14 16 10 04 15 10 06 05 05 13 01 17 08 14 01 10 08 06 07 06 03 09 01 20 03 03 11 03 07 20 
19 13 15 20 08 02 09 13 18 06 17 18 02 04 12 03 06 19 20 12 16 03 20 16 14 03 10 17 17 17 
08 08 09 14 07 16 15 08 20 13 05 16 02 06 19 13 20 04 03 20 16 10 14 07 17 19 01 07 15 18 
03 02 05 03 16 03 10 02 02 09 06 06 04 08 04 02 20 03 18 15 14 05 16 07 11 13 06 04 19 12 
01 13 06 17 15 13 11 16 14 13 04 20 10 19 07 13 12 18 16 09 04 09 13 20 08 16 12 05 19 02 
16 11 14 01 19 20 13 09 15 19 13 10 18 03 08 16 15 19 05 02 08 09 03 12 20 10 07 03 14 17 
04 01 07 17 14 17 08 18 18 02 16 10 03 05 04 10 20 11 08 17 12 07 17 14 11 16 15 17 18 20 
06 13 01 04 09 14 01 08 11 18 01 19 19 03 03 15 12 15 05 11 11 08 10 19 14 20 14 08 08 03 
08 13 15 20 17 15 13 09 14 15 18 14 05 16 16 08 02 07 02 18 09 04 06 18 14 19 09 19 18 17 
01 05 09 07 16 17 13 08 05 06 15 02 19 19 10 14 18 11 12 11 09 20 06 06 10 19 16 18 17 13 
14 09 10 15 15 05 11 19 05 16 04 11 17 14 09 06 07 19 09 10 09 09 10 15 14 11 05 01 08 02 
13 02 10 02 16 17 19 18 15 03 13 19 13 10 12 13 07 11 03 15 20 12 03 01 18 08 11 02 08 19 
15 13 12 05 06 19 01 04 16 07 18 09 05 02 10 09 07 08 11 09 03 02 12 17 03 01 17 13 03 16 
03 09 08 06 13 14 04 05 09 12 12 07 20 08 20 01 08 06 08 18 15 02 20 18 19 14 19 07 06 13 
02 01 01 10 06 14 15 02 10 15 13 01 13 04 01 13 04 08 18 03 18 04 05 09 14 15 02 12 01 19 
04 14 19 04 03 17 09 09 18 19 04 10 11 16 13 11 20 08 11 10 10 08 13 06 16 18 20 09 09 12 
07 12 06 18 08 20 14 08 01 11 06 04 12 09 11 16 11 11 03 01 20 04 20 04 10 07 02 01 15 02 
13 02 06 10 19 13 09 12 20 09 14 18 04 17 18 07 12 08 09 06 09 20 01 20 03 02 07 16 03 01 
10 07 14 15 08 12 19 16 15 18 17 20 07 12 16 04 18 19 12 06 04 12 05 05 03 20 18 09 07 20 
02 16 18 15 10 05 07 08 13 13 18 01 13 16 12 08 12 02 07 15 19 02 06 16 18 20 15 16 09 13 
15 10 01 05 04 10 09 02 10 13 15 19 13 19 06 05 06 17 06 04 11 16 06 08 11 03 08 05 18 08 
10 05 17 10 01 12 11 09 06 12 14 12 10 06 10 16 10 07 04 07 11 15 03 16 02 13 10 01 10 20 
08 11 16 16 20 16 08 02 16 05 14 09 16 15 15 05 10 16 11 06 15 13 20 09 20 13 01 10 14 02 
01 13 04 16 09 15 11 16 17 18 12 10 07 07 04 13 03 06 08 05 11 14 18 02 02 17 14 15 06 19 
16 18 12 12 13 20 06 15 07 02 13 18 03 11 16 07 03 18 04 02 02 14 16 11 15 17 08 20 11 05 
19 19 03 02 10 15 01 07 02 19 09 06 16 11 16 03 09 10 12 12 11 13 17 18 16 03 07 03 03 17 
07 13 07 09 14 08 16 06 15 09 04 15 14 11 17 01 05 06 10 16 09 12 20 18 02 15 20 08 17 14 
