30 30 12
09 07 11 05 12 09 01 03 10 12 01 08 11 11 06 09 09 04 02 05 09 09 07 03 05 11 08 11 09 06 
06 09 05 08 01 04 04 06 10 05 05 03 01 07 01 06 08 09 01 01 02 09 10 12 03 02 10 02 05 10 
12 10 06 04 05 11 11 12 04 08 05 12 10 09 11 10 06 06 07 06 06 12 06 03 03 08 09 05 01 01 
02 12 10 12 03 06 02 01 05 05 01 01 08 10 09 06 12 02 03 06 07 01 09 12 07 11 11 03 03 12 
03 09 11 04 12 06 09 01 10 06 09 10 06 04 08 03 02 07 08 04 04 03 04 12 06 11 02 09 05 05 
12 12 01 02 03 12 07 04 04 05 01 12 06 06 03 01 12 04 11 08 08 06 02 03 09 11 05 11 07 10 
03 06 09 07 08 03 10 06 10 01 02 10 12 08 08 02 08 07 10 11 06 09 08 07 11 05 06 08 03 04 
05 09 02 05 03 01 11 04 06 09 04 08 10 07 03 05 12 02 12 09 04 05 05 12 04 08 04 01 03 10 
04 11 06 05 07 12 05 05 03 03 05 10 10 03 04 04 07 03 09 10 12 01 07 08 04 10 03 11 10 09 
08 05 07 01 02 05 04 10 02 06 12 06 07 01 12 10 04 11 12 05 08 03 09 02 03 12 03 05 10 04 
06 09 09 04 09 10 09 04 07 10 01 11 07 07 11 11 04 07 09 07 11 08 02 11 02 04 10 04 12 11 
08 05 07 08 09 07 05 09 02 03 10 02 05 04 08 04 06 11 10 06 09 12 02 10 02 03 05 03 10 05 
01 05 09 11 04 09 09 08 05 10 03 02 11 07 10 06 02 03 08 03 09 04 06 02 06 07 08 10 09 05 
02 01 02 03 11 05 11 11 05 04 08 11 05 10 05 02 03 11 09 02 01 09 06 07 10 03 05 09 12 02 
01 02 02 02 04 05 11 06 03 03 09 11 01 02 08 09 07 03 11 03 04 12 11 01 10 12 03 02 08 03 
07 01 08 09 06 03 01 04 08 07 10 05 05 02 10 05 03 08 11 01 11 06 04 01 07 05 05 09 07 04 
03 05 04 02 01 10 04 05 05 04 12 03 08 08 08 09 04 10 04 02 11 06 08 06 07 06 11 03 02 09 
06 09 01 10 10 02 11 06 10 07 09 09 01 08 09 09 04 12 06 11 06 08 05 05 06 03 10 04 05 03 
12 02 11 12 11 01 05 01 06 03 08 02 03 08 09 11 08 04 03 06 02 08 01 10 12 10 12 01 01 08 
03 12 10 06 04 12 06 12 05 11 02 12 04 09 11 04 11 07 07 01 12 12 12 04 10 03 02 01 03 06 
09 06 10 10 11 01 09 04 12 01 06 06 04 01 06 07 04 04 05 02 05 08 05 08 11 06 11 04 07 01 
02 07 10 11 08 08 03 04 03 02 09 12 11 04 12 04 10 07 08 02 08 04 09 01 03 12 10 01 07 04 
06 08 02 03 06 09 11 08 05 05 02 05 05 04 08 04 12 10 11 11 03 10 02 04 02 08 03 12 09 01 
03 02 01 09 04 06 05 06 06 01 11 11 05 07 06 01 10 05 10 12 03 04 10 08 07 11 04 09 10 04 
02 05 05 02 05 12 11 09 10 08 02 12 06 06 06 12 06 07 08 07 07 11 11 04 06 05 06 01 06 08 
04 11 04 12 12 08 12 02 08 01 10 09 12 07 03 05 06 12 11 06 11 09 04 01 04 01 05 10 02 02 
09 09 04 12 09 07 07 08 09 06 12 06 03 11 12 09 07 10 08 09 03 10 06 10 10 09 10 07 06 03 
08 06 12 04 05 08 10 03 07 06 09 06 03 03 08 03 11 02 04 10 10 06 08 07 03 05 04 04 11 01 
07 11 07 10 02 11 05 03 06 03 09 06 08 11 08 07 05 10 12 08 07 09 05 06 08 11 03 11 03 01 
11 01 03 05 10 08 08 06 11 05 08 11 10 07 01 09 05 06 06 04 05 04 04 02 02 11 12 04 09 06 
