30 30 15
14 15 08 02 04 03 13 09 07 05 10 11 03 04 09 11 05 11 09 10 07 05 11 06 04 14 05 06 14 07 
01 13 13 15 14 01 10 04 01 01 08 10 03 02 14 11 12 10 13 05 04 04 01 06 02 11 11 06 09 10 
04 09 07 01 01 12 08 10 15 09 02 14 10 04 15 15 06 11 09 03 07 04 06 15 01 14 10 12 05 03 
13 08 04 04 01 11 07 08 05 14 01 06 12 03 09 04 02 06 06 11 08 13 14 05 12 15 04 13 03 15 
08 15 14 03 10 14 13 01 07 02 06 14 14 03 01 14 13 10 04 03 05 03 07 10 07 10 01 10 08 03 
01 07 09 15 09 03 13 13 11 11 06 01 02 04 10 09 09 07 03 12 10 14 14 01 09 12 11 01 14 10 
04 14 01 04 13 01 07 03 13 09 05 10 09 06 05 11 15 13 02 09 09 03 08 14 04 08 10 06 08 15 
07 03 14 07 07 11 14 05 05 03 13 10 12 13 15 01 08 06 13 10 07 13 04 06 03 07 13 04 04 12 
04 10 15 02 08 13 04 06 02 01 08 06 10 11 10 01 11 03 14 15 04 12 04 07 02 06 06 06 02 01 
02 05 11 08 13 10 05 08 01 13 08 15 10 09 03 05 02 05 14 15 05 02 11 15 15 04 06 05 09 14 
06 10 03 08 10 07 02 06 06 09 11 14 01 05 14 03 01 15 07 14 06 03 07 08 03 07 11 15 11 04 
13 08 06 07 07 15 05 01 05 10 09 07 15 01 12 14 10 04 05 02 03 11 11 01 03 05 07 14 04 10 
09 08 09 14 06 01 05 10 01 02 05 01 08 04 02 11 09 03 15 14 04 09 01 07 09 10 11 01 15 07 
02 09 14 10 14 12 02 04 06 02 05 02 10 12 13 03 08 06 05 14 11 01 07 03 07 07 13 09 14 12 
15 15 12 06 02 11 02 03 14 14 12 10 01 13 13 05 15 05 10 11 10 13 11 01 15 09 08 04 03 06 
08 09 13 04 06 14 14 14 01 04 13 04 13 05 01 11 09 15 07 10 11 02 07 13 09 14 07 01 09 01 
14 01 01 11 05 07 01 03 05 01 14 02 05 11 13 12 06 06 12 05 08 14 06 14 03 14 04 01 07 13 
01 05 05 02 07 09 15 07 04 04 14 02 13 10 04 10 07 02 08 10 06 15 15 11 05 02 01 09 03 14 
13 10 03 02 03 01 03 02 14 06 06 13 14 03 07 02 04 05 03 11 14 08 10 13 10 07 07 03 07 09 
01 04 03 11 12 13 03 06 14 02 03 04 14 01 13 12 10 02 02 12 12 07 12 14 05 13 05 11 07 03 
11 15 06 05 10 09 02 12 15 01 05 02 11 03 10 09 15 04 10 08 07 13 14 10 03 10 08 14 12 06 
01 07 05 13 04 06 07 05 10 13 12 14 14 08 02 15 01 08 03 02 07 02 14 05 11 02 15 10 07 03 
01 08 10 05 05 05 11 11 09 05 15 13 03 06 12 11 05 04 10 15 05 01 01 10 13 11 03 04 13 10 
06 13 02 07 09 13 11 04 09 12 15 08 01 10 05 12 12 10 15 07 09 11 14 01 05 03 03 08 13 15 
09 04 12 02 02 06 14 05 01 07 01 08 07 08 02 11 04 13 12 03 11 12 05 02 12 09 04 15 08 09 
14 01 04 03 02 05 15 01 09 07 14 01 14 12 08 15 15 03 05 11 12 07 08 01 08 11 10 04 10 09 
12 01 10 15 10 03 11 09 10 05 15 01 12 14 04 05 05 03 14 01 06 11 08 05 11 07 15 05 10 02 
14 13 02 15 12 11 09 08 11 04 04 10 11 07 15 14 03 12 09 02 12 14 12 11 03 07 03 09 04 04 
10 09 02 03 08 05 05 08 04 15 03 07 02 13 14 08 12 01 04 05 02 08 10 05 03 04 12 05 12 15 
01 14 08 02 08 07 06 05 14 10 04 02 08 12 14 13 05 02 06 15 13 14 07 07 04 02 02 15 13 14 
