30 30 20
10 01 15 07 10 17 19 15 19 18 11 01 09 14 15 07 14 06 13 05 19 10 17 04 09 09 15 18 18 01 
17 07 01 04 06 02 20 04 08 18 02 19 11 02 04 05 09 17 02 13 01 01 03 09 16 03 18 10 20 15 
02 09 01 15 12 06 16 03 02 04 20 15 14 02 16 09 07 16 05 08 09 18 20 03 06 16 05 03 17 17 
17 19 05 10 05 08 07 12 10 08 07 01 14 20 03 10 20 01 17 05 08 17 02 20 19 07 07 04 10 15 
12 18 05 16 07 09 15 14 01 04 13 07 16 19 19 10 08 18 10 16 14 10 13 15 09 03 14 07 06 03 
13 17 12 18 04 19 18 10 04 18 05 08 17 01 06 07 10 05 16 20 13 10 09 05 04 09 07 17 07 05 
11 19 13 03 16 09 13 14 18 08 03 03 07 11 15 13 17 16 09 13 15 01 02 15 17 17 15 16 14 01 
20 16 12 04 10 07 12 02 12 02 09 07 16 16 17 10 20 06 17 20 10 12 01 11 18 09 19 13 04 12 
05 15 20 16 19 09 15 02 11 06 15 11 04 10 18 13 11 09 18 08 09 07 11 01 09 08 09 07 12 13 
11 17 07 10 12 17 10 06 19 12 04 05 03 07 15 12 11 17 13 20 04 01 06 06 13 06 06 01 05 17 
05 15 13 04 16 05 12 05 02 02 09 05 07 11 04 01 14 14 09 06 14 13 18 11 10 10 09 15 03 13 
12 19 19 04 14 06 20 06 02 14 07 10 18 13 12 13 05 06 19 14 03 12 18 01 14 07 02 14 02 04 
06 05 15 16 20 08 01 20 13 03 05 12 04 02 04 16 07 09 13 05 14 15 16 11 07 01 17 09 15 10 
04 12 14 18 08 14 06 20 05 10 02 09 01 06 02 05 13 08 05 05 12 18 19 19 08 18 12 16 06 18 
18 01 09 11 19 16 16 16 16 12 05 09 12 18 06 06 14 18 05 10 14 09 07 05 19 06 02 10 13 19 
07 10 19 16 13 17 03 20 04 10 12 01 11 15 18 16 20 11 06 17 20 19 05 18 03 03 15 16 05 19 
14 11 09 13 18 01 01 13 12 05 02 03 05 12 10 14 20 01 16 05 17 07 15 01 16 10 16 10 17 20 
08 11 10 08 15 20 20 15 12 12 11 05 06 07 17 15 20 08 16 07 04 12 13 10 05 08 19 20 09 16 
19 09 18 20 16 12 19 16 18 10 19 01 07 04 07 03 11 19 02 06 05 05 09 10 14 05 17 05 04 18 
12 14 06 09 14 13 12 04 20 09 06 18 01 12 14 08 06 04 18 07 01 02 03 09 11 16 14 20 12 09 
09 03 03 14 11 08 06 14 11 18 15 16 15 15 07 08 02 12 03 19 10 03 13 12 04 15 08 09 06 11 
17 14 14 11 19 16 18 17 10 09 14 04 16 08 18 15 08 12 06 02 10 16 05 14 19 20 09 18 08 14 
09 16 08 02 07 06 17 16 02 18 16 07 01 12 15 11 06 14 02 03 07 11 10 03 17 09 02 05 06 09 
18 14 17 17 07 03 15 04 10 08 01 06 15 14 09 01 04 14 06 05 08 12 07 18 15 03 18 16 07 03 
17 17 09 13 05 15 07 19 10 08 19 03 13 13 16 01 13 19 06 18 15 14 09 01 03 15 16 20 11 14 
14 19 10 02 03 07 09 09 17 18 08 15 20 01 19 07 01 11 17 19 20 11 12 01 12 14 15 07 05 05 
12 18 03 14 12 05 20 20 05 08 09 13 03 01 05 01 07 17 04 04 15 03 06 18 03 09 11 18 07 15 
14 19 05 09 12 16 05 11 07 10 18 07 14 12 07 10 05 06 06 08 01 01 10 06 18 05 15 01 14 01 
07 07 19 11 15 10 18 20 12 16 01 02 03 06 13 09 15 17 14 20 04 06 12 06 12 02 02 18 02 15 
18 20 01 09 03 16 10 20 07 02 08 07 15 10 12 07 18 06 04 04 17 19 01 09 16 12 10 17 01 03 
