5 5 5
4 5 4 2 5 
5 3 1 3 2 
1 3 5 3 3 
2 1 1 3 4 
3 4 1 3 1 
