5 5 7
7 7 2 5 4 
4 2 6 3 4 
3 2 3 3 7 
3 2 5 6 3 
7 3 1 3 1 
