5 5 5
4 3 2 3 3 
1 5 3 3 3 
5 3 1 4 3 
5 4 2 5 2 
2 4 3 3 3 
