5 5 5
5 1 5 2 5 
2 4 5 4 3 
1 1 4 4 5 
2 4 1 3 5 
4 5 2 4 4 
