5 5 7
4 3 4 7 3 
3 7 1 5 6 
1 6 6 5 1 
5 5 4 6 6 
1 3 7 7 2 
