5 5 7
1 1 4 5 7 
5 7 7 2 7 
1 6 4 5 4 
6 2 4 3 1 
6 6 1 5 3 
