5 5 5
4 5 3 2 4 
3 3 4 2 5 
5 1 3 4 4 
1 5 1 4 5 
2 5 1 1 4 
