5 5 7
3 7 1 4 2 
6 5 5 4 1 
1 4 7 5 4 
2 5 4 7 4 
6 1 3 5 6 
