5 5 5
2 3 1 5 1 
5 5 4 1 4 
4 2 2 4 5 
3 4 3 4 4 
5 2 4 4 1 
