5 5 7
2 7 4 7 7 
7 7 5 7 2 
2 7 1 2 1 
5 4 2 5 4 
7 4 3 7 1 
