5 5 5
3 4 1 4 4 
2 2 2 2 2 
3 2 1 5 2 
1 5 1 3 1 
4 2 3 5 1 
