5 5 5
5 4 5 2 4 
4 1 1 3 1 
1 2 4 5 3 
4 5 2 1 1 
5 5 4 5 2 
