5 5 7
3 7 3 5 1 
2 2 4 3 2 
6 4 1 3 7 
7 7 6 2 4 
1 1 7 6 7 
