5 5 7
4 7 1 5 7 
1 2 5 7 5 
1 1 2 3 2 
6 1 6 3 7 
4 5 7 4 3 
