10 10 6
5 5 2 1 2 5 1 4 6 1 
6 4 6 4 2 6 4 3 3 4 
1 5 3 4 6 5 2 6 4 6 
5 6 2 6 4 1 2 2 3 5 
1 2 3 6 3 2 3 4 4 5 
2 5 3 2 6 2 4 5 6 5 
2 4 2 3 1 6 4 3 5 4 
5 5 5 1 3 5 1 5 3 4 
2 2 6 4 3 4 4 4 2 1 
2 4 4 3 4 4 6 1 4 5 
