10 10 6
6 3 2 6 3 6 2 2 5 6 
3 5 6 1 2 6 3 2 4 6 
6 1 4 6 4 2 1 2 2 3 
2 6 5 3 5 5 2 5 6 6 
4 6 3 2 4 2 5 1 1 2 
4 6 6 6 3 1 5 2 1 6 
2 2 5 4 4 2 3 3 4 2 
6 5 6 2 6 3 1 4 1 2 
3 5 5 6 4 6 1 2 1 1 
5 2 6 2 5 3 1 1 5 4 
