10 10 6
4 3 6 3 4 1 4 3 3 4 
6 1 6 2 2 1 3 6 3 2 
4 3 1 1 6 4 4 4 4 1 
6 1 4 5 1 5 3 2 1 5 
5 4 6 5 5 5 3 6 5 6 
1 2 6 5 6 5 2 3 6 3 
2 5 3 5 2 1 3 4 3 1 
1 5 4 4 1 6 2 4 5 4 
1 3 3 6 1 3 2 6 3 1 
2 4 5 2 2 6 3 2 2 5 
