10 10 10
3 7 8 10 8 4 7 6 1 1 
2 10 10 10 2 6 3 3 8 8 
1 4 3 2 6 7 4 9 5 7 
5 9 3 2 9 2 8 7 7 10 
9 10 1 9 10 3 4 4 5 4 
1 7 9 5 9 4 3 4 5 8 
10 9 8 5 3 8 6 10 4 3 
1 3 2 1 3 3 3 8 6 10 
1 9 6 1 5 4 7 8 9 1 
7 9 9 4 3 1 4 10 2 7 
